What is MyChart 	I do not know what MyChart is 	A1R1J3GL0YP7DJ
Can I bring a bicycle or roller-blade 	I do not know if you can bring a bicycle or roller-blade 	A298FAWY76NZA9
Where is the gift shop 	I do not know where the gift shop is 	A1XNCA1SVTT15B
Can you help me change the pin code to my account so I can access it 	I am not able to help you change the pin code to your account	A23CTGXNDDW5LC
Who should enroll in the short term disability plan 	I do not know who should enroll in the short term disability plan 	AFS36YMNN8A2J
Where do I find information about my ancestors 	I do not know where you can find information about your ancestors 	A2K9PB0U45O0MU
Where do the ECOMUSEUM zoo animals come from	I do not know where the ecomuseum zoo animals come from	A23CTGXNDDW5LC
Do I need to show my I.D. to pick it up 	I do not know if you need to show your I.D. to pick it up	A23CTGXNDDW5LC
I want to order a subscription for a friend , do you have a gift option 	I do not know if we have a gift option 	A2EAJXBORHT44T	
What kind of objects , and how many of them are in the collection 	I do not know what kind of objects or how many of them are in a collection 	A2ZLJQWCM8KU36
Is the Penn Museum , the Museum Archives , and the Museum Library open to the general public 	I do not know if the Penn Museum , the Museum Archives , and the Museum Library are open to the general public 	A2NI2HSU84PHJW
Can you check if I qualify for the program 	I am not able to check if you qualify for the program 	A3U6CLX7HD0SMF	
Will you refund my shipping charges 	I am not able to refund your shipping charges 	A3VV5FFG6GXE1S	
Is package tracking available 	I do not know if package tracking is available 	AE9M4Z1NCYSDM	
Can you pre-order this item 	I do not know if you can pre-order this item 	A2C3I4DWGVPA1O
I need to change my address , can you help me with that 	I am not able to help you change your address 	A31A4YKVSOYRVS	
What day is the new phone going to be in stock 	I do not know what day the new phone is going to be in stock 	A31A4YKVSOYRVS	
Is Membership a value for me	I do not know if membership is a value for you 	A1JBSFXMMRGSQD
Which classes can I use the Class Pass for 	I do not know which classes you can use the Class Pass for	A2K9PB0U45O0MU
Can you change my shipping from expedited to standard 	I am not able to change your shipping from expedited to standard 	A3GNQDFPZALU92	
Are the Zoo and Gardens accessible to people with disabilities 	I do not know if the Zoo and Gardens accessible to people with disabilities 	A3U0VQ420HIMQ0
Can I have the car inspected at a mechanic 	I do not know if you can have the car inspected at a mechanic 	A235UQRA8GE18X
What are the incentives for coach drivers 	I do not know what the incentives for coach drivers are 	A2TP3K1THK6XRB
My spouse and I are filing as married filing separately . We both contributed to the support of our son . Can we both claim a dependency exemption for him on our separate returns 	I do not know if you and your spouse can both claim your son as a dependency exemption if you file separate returns , since you both contributed to his support 	A1JBSFXMMRGSQD
Can I use Robo-Dialer to make international calls 	I do not know if you can use Robo-Dialer to make international calls 	A2NI2HSU84PHJW
Could you please check on the status of my order 	I am not able to check on the status of your order 	AD9O852KPYLHY	
When can I select or change my seat 	I do not know where you can select or change your seat 	A2D0IIX70FDQIW
When can I expect to hear about the status of my application 	I do not know when you can expect to hear about the status of your application 	A2K9PB0U45O0MU
What tax rate is due on residential construction projects -LRB- houses , apartments , etc. -RRB- 	I do not know what tax rate is due on residential construction projects -LRB- houses , apartments , etc. -RRB- 	A16VTK6KZ1U69H
What is Classroom Mode and how do I use it 	I am not able to tell you what Classroom Mode is , or how to use it 	AT7ADQKXKXEWY
I need to finalize my summer plans prior to the notification date . Is it possible to expedite the application review process 	I do not know if it is possible to expedite the application 	A3SQIRU1XI54BR
How are trade-in values determined 	I do not know how trade-in values are determined 	A1IPD4WBT3A5GG
What adventure activities are there in Guatemala	I do not know what adventure activities there are 	A13GUTDMGGZZDL
I do not work the regular 8:45 a.m. -- 5 p.m. work schedule . How will I know if and when I need to report to work if the University had an early dismissal or did not open 	I do not know how you will know if and when you need to report to work if the University had an early dismissal or did not open , and you do not work the regular 8:45 a.m.-5 p.m. work schedule 	A1JBSFXMMRGSQD
Where can I find the latest news and information on Coca-Cola alumni 	I do not know where you can find the latest news and information on Coca-Cola alumni 	A1JBSFXMMRGSQD
What types of training are available for my company 	I do not know what types of training are available for your company 	A3G2FBKYCRD5Q8
Why is n't my internet service working 	I do not know why your internet service is n't working 	AD9O852KPYLHY	
Why is it taking so long to process my return	I do not know why it is taking so long to process your return 	AJKA9BKC011F2
Where do I go to report for jury duty 	I do not know where you go to report for jury duty 	A7SXWHGK8B40R
How often do I need to replace the battery on this carbon monoxide detector 	I do not know how often you need to replace the battery on that carbon monoxide detector 	A3GNQDFPZALU92	
Do you guys ship to Indonesia 	I do not know if we ship to Indonesia 	A2PKDWREQV1JTR
This product came to me in a different size than I ordered and I need help fixing it 	I am not able to help fix the product coming to you in a different size than you ordered 	A3GNQDFPZALU92	
What is the Intel login 	I do not know what the Intel login is 	A3U0VQ420HIMQ0
Can my daily admission ticket be used for ZooTunes or other zoo events 	I do not know if your daily admission ticket can be used for ZooTunes or other zoo events 	AJ7E01X4TAGHL
Do your vehicles carry a Factory Warranty 	I do not know if the vehicles carry a Factory Warranty 	A2NI2HSU84PHJW
I received an email about login.gov . Is this a real email 	I do not know if this is a real email 	A2NI2HSU84PHJW
My rental car broke down in Weippe , what do I do to get another 	I do not know what you do to get another rental car after yours broke down in Weippe 	A1GAARR4GOOZCO	
I want to know if my request to change my account number has been approved 	I do not know if your request to change your account number has been approved 	A325WS381BHOHH	
Is there an online manual available for this product 	I do not know if there is an online manual for this product 	AD9O852KPYLHY	
Do you have any discounts for new members 	I do not know if we have any discounts for new members 	A31A4YKVSOYRVS	
How many species of cetaceans in US waters are protected under the Endangered Species Act 	I do not know how many species are protected 	A13GUTDMGGZZDL
May overtime be averaged out over two or more weeks 	I do not know if overtime can be averaged over two or more weeks 	A2NI2HSU84PHJW
I would like to take advantage of the free shipping , but my order only totals $ 41 . Can you suggest a $ 9 item to get to the $ 50 free shipping amount 	I am not able to suggest a $ 9 item 	A31A4YKVSOYRVS	
Is there a restaurant or place to eat lunch at the Zoo 	I do not know if there is a restaurant or place to eat lunch at the Zool	A2HKTM4Z8652
Do the revised vacation , sick and personal time policies delineate how much time employees get based on when they are hired or terminated or begin or return from an unpaid leave of absence 	I do not know if the revised policies delineate how much time employees get 	ARKAJ6PL85CME
Do I need to file a police report if my registration was lost or stolen 	I do not know if you need to file a police report if your registration was lost or stolen 	A3CL6GEDFNQGQY
How does the name of the Museum relate to the earliest people or settlers 	I do not know how the name of the Museum relates to the earliest people or settlers 	A7SXWHGK8B40R
How can I learn more about my Xerox Products 	I do not know how you can learn more about Xerox products	APF1EAZT104LQ
I have n't received my order ; can you track it please 	I am not able to track your order 	A31A4YKVSOYRVS	
When are tours held 	I am not able to tell you when tours are held	APF1EAZT104LQ
Will I receive a confirmation for my groups visit 	I do not know if you will receive a confirmation for your group 's visit 	A2NI2HSU84PHJW
Sudden emergency here , can I cancel the order I just made 	I am not able to cancel the order you just made 	A3RD486RQUI2XV
Do you offer express shipping to Alaska 	I do not know if we offer express shipping to Alaska 	ASFR82SJYMGNU
How do I set up autorenewal billing 	I do not know how to set up autorenewal billing 	AMW07CJC3OJIB
Can I park and ride to the Historic Dockyard	I do not know if you can 	A1DWQO9X2ZQ35G
How long do I have to wait for the refund to show back up in my bank account 	I do not know how long you will have to wait for the refund to show back up in your account 	A31A4YKVSOYRVS	
Is there a tentative schedule for job announcements 	I do not know i there is a tentative schedule for job announcements 	A2D0IIX70FDQIW
Is Photography allowed on site 	I do not know if photography is allowed on site 	AFK0MM5DQUUG5
What shipping documents do I need to ship a FedEx Express package internationally 	I do not know what shipping documents you need to ship a FedEx Express package internationally	A23CTGXNDDW5LC
How are Travel Advice and Advisories developed and maintained 	I do not know how Travel Advice and Advisories are developed and maintained 	A1X3SF2W1QQBY1
Can written offers of employment for security/safety sensitive positions be made by email 	I do not know if written offers of employment for security/safety sensitive positions can be made by email 	A2NI2HSU84PHJW
How do I login to HR Self Service 	I do not know how to login to HR Self Service 	A7SXWHGK8B40R
Why is my account no longer available 	I do not know why your account is not available 	A1F46RJTOXQM4J
What type of format can I use to apply for a Federal government job 	I do not know what type of format you can use to apply for a Federal government job 	A3CL6GEDFNQGQY
What are the differences between the Intel Media Server Studio editions , and why should I upgrade to the Professional edition 	I do not know the differences between the Intel Media Server Studio editions or why you should upgrade to the Professional edition 	A2K9PB0U45O0MU
I am a dialup user and why am I having difficulties reserving a ticket online 	I do not know why you are having difficulties reserving a ticket online 	A2EJ7U3TZAKROG
How do I browse through collections 	I do not know how you browse through collections 	A13GUTDMGGZZDL
I put product in my cart but it did n't show up in checkout 	I am not able to help with the product being put in your cart but not showing up in checkout 	A3GNQDFPZALU92	
Do I need collision and liability for a car that old 	I do not know if you need collision and liability for a car that old 	ASFR82SJYMGNU
Does the BioPark accept pet donations 	I do not know if the BioPark accepts pet donations 	A3G2FBKYCRD5Q8
How much time should I allow for my visit	I do not know how much time you should allow for your visit 	A1J0GU26323WVA
Is there a place to park my STROLLER	I do not know where you can park your stroller 	A1HLG5NN2I16GN
May an employer have its third-party benefits administrator -LRB- TPA -RRB- obtain a health plan identifier -LRB- HPID -RRB- for the employer 's self-insured plan 	I do not know if an employer can obtain a health plan identifier -LRB- HPID -RRB- for the employer 's self-insured plan 	A13GUTDMGGZZDL
I need a letter of attestation of employment for my mortgage -LRB- or any purpose you may need it for -RRB- , where can I get one 	I do not know where you can get a letter of attestation of employment for your mortgage -LRB- or any purpose you may need it for -RRB- 	AZLZA0Q87TJZO
Can I volunteer at the Museum 	I do not know if you can volunteer at the Museum 	A3R71HP45TBQ7O
How long has the Zoo been accredited by the AZA 	I do not know how long the Zoo has been accredited by the AZA 	A6ZEHD61NRBWA
How will I know if a position has been filled or closed 	I do not know how you will know if a position has been filled 	A2K2MFQMN31DZ
How much time should I allot for the museums located on Naoshima 	I do not know how much time you should allot for the museums located on Naoshima 	ARKAJ6PL85CME
How do I change my name on my account 	I do not know how to change your name on your account 	A3RO0QIXW4IX3Y
How do I earn Mileage Plan miles 	I do not know how you earn Mileage Plan miles 	A1JBSFXMMRGSQD
How do I determine whether a student position is security-sensitive given their access to information technology systems 	I do not know how to determine whether a student position is security-sensitive given their access to information technology systems 	A2K9PB0U45O0MU
Do you have any more of these available 	I do not know if we have any more of these available 	AQLHX3G8KP4TS
Are pets allowed at the Air Museum 	I do not know if pets are allowed at the Air Museum 	A14M2EERU7E8KD
Does the shipped address and the billing address have to be the same 	I do not know whether the shipped address and the billing address have to be the same 	A1OPGPTQJ48XOY	
Why would I want to switch to your service 	I do not know why you would want to switch to our service	A23CTGXNDDW5LC
Are Cameras permitted in the Museum	I do not know if cameras are permitted in the museum 	A2223XYV804AY7
How do I find beekeeping associations or publications 	I do not know how you find beekeeping associations or publications 	A2HKTM4Z8652
May I visit the Zoo before I get my card 	I do not know if you may visit the zoo before you get your card 	A2LQ9NP944M61Z
Can someone from outside of UCSB -LRB- including other UC campuses -RRB- donate vacation time to an eligible employee through the Catastrophic Leave Sharing Program 	I do not know if someone from outside of UCSB -LRB- including other UC campuses -RRB- can donate vacation time to an eligible employee through the Catastrophic Leave Sharing Program 	A1J0GU26323WVA
Do you have performance opportunities for teens and adults 	I do not know if there are performance opportunities for teens and adults 	A2LQ9NP944M61Z
What formats are available for community screenings 	I do not know the formats that are available for community screenings 	A2VIKCIM9TZL22
I heard that you had this product but I ca n't find it on your website , can you help me 	I am not able to help you find the product on our website 	A31A4YKVSOYRVS	
I have lost or misplaced my membership card . How can I request a replacement 	I do not know how you can request a replacement card 	A3R71HP45TBQ7O
Do I need to replace lost stickers 	I do not know if lost stickers need to be replaced 	A234VIHHUHPZG5
How do I ensure that I receive the miles I earned 	I do not know how you ensure you receive the miles 	A3SQIRU1XI54BR
I booked on a website other than the hotel website and I need to make a change to my reservation . How do I do this 	I do not know how you do this	A23CTGXNDDW5LC
What ages are best for visiting the museum 	I do not know what the best ages are 	A13GUTDMGGZZDL
What actions do I need to take 	I do not know what actions you need to take 	A2NI2HSU84PHJW
How do I join Choice Privileges 	I do not know how you join Choice Privileges 	A27MJOV91GA8R3
My balance is n't showing in my account 	I am not able to tell you why your account balance is n't showing 	A31A4YKVSOYRVS	
My tracking information shows that a package was left at my address , but I ca n't find it . What should I do 	I do not know what you should do if your tracking information shows that a package was left at your address , but you ca n't find it 	A16VTK6KZ1U69H
How long will it take for my member card -LRB- s -RRB- to arrive 	I do not know how long it will take for your member card -LRB- s -RRB- to arrive 	A3U0VQ420HIMQ0
How much time should be allocated for a school / group visit to the zoo 	I do not know how much time to allocate for a school/group visit to the zoo 	A1BYVSM1G333O4
Do you have guided tours 	I do not know if we have guided tours 	A2K2MFQMN31DZ
If I 'm traveling with someone , can we sit together 	I do not know if you can sit with someone you are traveling with 	AQ9Y6WD8O72ZC
Can you help me change me shipping address 	I am not able to help you change your shipping address 	A185P3B2MC2K83
Why did I only receive one card in the mail 	I do not know why you only received one card in the mail 	A1JBSFXMMRGSQD
Can you help me find a particular quotation I saw at the Museum 	I am not able to help you find a particular quotation you saw at the Museum 	AGYTXEJ804L4W
What is Bucket Filling 	I do not know what a Bucket Filling is 	A2UBEPT605E8T2
Can I pay with two different cards 	I do not know if you can pay with two different cards 	AE9M4Z1NCYSDM	
Are service animals allowed in the museum 	I do not know if service animals are allowed in the museum 	A1IPD4WBT3A5GG
Any good ingredients are in belVita Breakfast Biscuits , Golden Oat 	I do not know if there are any good ingredients in belVita Breakfast Biscuits or Golden Oat 	A7SXWHGK8B40R
Did Perth Zoo once have polar bears	I do not know if Perth Zoo had polar bears 	A10249252O9I20MRSOBVF
Does the Museum have a Gift Shop 	I do not know if the museum has a gift shop 	A2K2MFQMN31DZ
Can I get checks with this account 	I do not know if you can get checks with this account	AYJGJAIY0EXW
Can an International Symbol of Access -LRB- ISA -RRB- for people with disabilities be placed on my specialty license plate 	I am not able to say whether an International Symbol of Access -LRB- ISA -RRB- for people with disabilities can be placed on your specialty license plate 	A1A0PNOBFTTHGP
What is the minimum order for delivery 	I do not know what the minimum order for delivery is 	A1YKWG46AWMPUX	
How will Northwestern use the Coalition platform 's Locker feature 	I do not know how Northwestern will use the Coalition platform 's Locker feature 	A2D0IIX70FDQIW
My account logged out during checkout , I do n't know if my item is still available 	I am not able to check if your item is still available 	A2EAJXBORHT44T	
Is it tough to work in FREETREND 's overseas factories 	I do not know if it is tough to work in FREETREND 's overseas factories 	A1A0PNOBFTTHGP
Can we leave to eat lunch and then return 	I do not know if you may leave to eat lunch and then return 	A1BYVSM1G333O4
How do I register for PACER 	I do not know how you would register for PACER 	A16NITTBMCSN0V
I got charged for two products instead of one , can you fix this 	I am not able to fix this	A224I9B6RFJZEI	
Where do I collect my park photographs 	I do not know where you can collect your park photographs	A1GNG0J27JYSUB
What changes are being made to the building 	I am not able to tell you what changes are being made to the building 	A116N2LEI6O7HB
Will there be opportunities for me to perform 	I do not know if there will be opportunities for you to perform 	APC99TPURUHR8
What postal carrier do you use 	I do not know what postal carrier we use 	A325WS381BHOHH	
Can you tell me what my minimum monthly payment is for my credit card balance 	I am not able to tell you what your minimum monthly payment is for your credit card balance 	A325WS381BHOHH	
Why are some prospective jurors instructed to report to the courthouse while others are told to call in for instructions 	I do not know why some prospective jurors are instructed to report to the courthouse 	A13GUTDMGGZZDL
How do I access Self-Service 	I do not know how you access Self-Service 	A2TP3K1THK6XRB
Are there any places to buy a meal or snacks 	I do not know if there are any places to buy a meal or snacks 	A1JBSFXMMRGSQD
Is the carousel operating today 	I do not know if the carousel is operating today 	A3U6CLX7HD0SMF
Can my friend pick up my order for me 	I do not know if a friend can pick up your order 	AKQ23WWJ57B8R	
Is there a Group or Car Club Rate available 	I do not know if there is a Group or Car Club Rate available 	A7SXWHGK8B40R
I received the product , but the instruction manual was not included . Can you send me one 	I am not able to send an instruction manual 	A1CQPRZUT6BW44
Can I talk to your supervisor 	I do not know if you can talk to my supervisor	A23CTGXNDDW5LC
What are Travel Advice and Advisories 	I do not know what Travel Advice and Advisories are 	A2VIKCIM9TZL22
Why can I set up a username in my account if I ca n't use it 	I do not know why you can set up a username in your account if you can not use it 	A1IPD4WBT3A5GG
Where can I find information on store hours	I do not know where you can find information on store hours 	A1JBSFXMMRGSQD
What credit options are available for people with bad credit 	I do not know what credit options are available for people with bad credit 	ASFR82SJYMGNU
Can I schedule for a repairman to come out 	I am not able to schedule a repairman for you	APF1EAZT104LQ
Is it true that if my daughter passes Driver 's Ed with an A , we get a discount on our car insurance 	I do not know if you will get a discount on your car insurance 	AD9O852KPYLHY	
What is my Coalition ID and where do I find it 	I do not know what your Coalition ID is , or where to find it 	A1X3SF2W1QQBY1
How much will it cost to overnight this package to me 	I do not know how much it will cost to overnight your package 	AD9O852KPYLHY	
Do the reporting requirements under Section 6056 apply to nonprofit and government employers 	I do not know if those requirements apply to nonprofit and government employers	APF1EAZT104LQ
Does the lawn pass get me reserved parking , early entry through MEMBER-ONLY gate or TD BANK VIP AREA ACCESS	I do not know if the lawn pass will get you reserved parking , early entry through member-only geate or TD bank VIP area 	A1GNG0J27JYSUB
Is there a cost or fee to volunteer 	I do not know if there is a cost or fee to volunteer 	A2NI2HSU84PHJW
What are the ' extras ' required for the year-end show 	I do not know what extras are required for the year-end show	A1CMT9MVUO52VP
May I cover my child -LRB- ren -RRB- under age 26 on my benefits plans if they are married and I am not claiming them on my income taxes 	I do not know if you may cover your children under age 26 on your benefits plans if they are married and you 're not claiming them on your income taxes 	A7SXWHGK8B40R
How is a copyright different from a patent or a trademark 	I do not know how a copyright is different from a patent or a trademark 	A13JQTLPWXZD6L
Can I reserve a place for a tour or encounter without payment	I do not know if you can reserve a place for a tour or encounter without payment 	A2K9PB0U45O0MU
I have a ' guest ' listed on my membership card , who can I bring	I do not know who you can bring if you have a ' guest ' listed on your membership card 	AZLZA0Q87TJZO
Can I get a quote to compare to a quote from another company 	I am not able to give you a quote to compare to a quote from another company 	APC99TPURUHR8
How late will I be at the courthouse 	I do not know how late you will be at the courthouse 	A7SXWHGK8B40R
Do you have a newsletter with updates about the Museum 	I am not able to provide a newsletter with updates about the Museum 	A14M2EERU7E8KD
How often do the exhibits change 	I do not know how often the exhibits change 	A13GUTDMGGZZDL
How do I add another driver to my insurance 	I do not know how you add another driver onto your insurance 	A2IXBTOWQRCLPZ	
If I upgrade to a new device , will the charge go directly to my bill 	I do not know if the charge will go directly on to you bill if you upgrade to a new device 	A3RD486RQUI2XV
Can I register a study after it has started , has closed to recruitment , or has been completed 	I do not know if you can register a study after it has started , closed to recruitment , or been completed 	AT7ADQKXKXEWY
Does my membership include free guest passes 	I do not know if your membership includes free guest passes 	A9LX66EQWDRQ5
Who is the administrative contact , and who is the technical contact 	I do not know the administrative contact IS OR who is the technical contact	ATQD23E8ESFSI
What English language qualifications do I need 	I am not able to tell you what english language qualifications you need	A3EMEMWJDM5DAR
I had an item on reserve but when I went to check out it was no longer available , what happened 	I am not able to tell you what happened to the item on reserve that was no longer available at check out 	AE9M4Z1NCYSDM	
How do leveled classes work at Dau	I do not know how leveled classes work at DAU 	A1JBSFXMMRGSQD
Can I Bring My Pet to Yellowstone 	I do not know if you can bring your pet to Yellowstone 	A1J0GU26323WVA
Do you have parking for disabled visitors 	I do not know if we have parking for disabled visitors 	A2K9PB0U45O0MU
How long do I have to return the product if I do n't like it 	I do not know how long you have to return the product 	A1HQRT1UG6ERGL
Can you please help me reverse some of these over drafts charges 	I am not able to help you reverse the over drafts charges 	A260AFDCSXBQOH
The customer rep I spoke with promised I could have the premium package at the regular price but I 've been billed too much 	I am not able to to give you the premium package at the regular price 	AD9O852KPYLHY	
What is dependent eligibility verification 	I do not know the eligibility verifications 	A2NI2HSU84PHJW
What are other benefits of dance 	I do not know other benefits of dance 	A3RD486RQUI2XV
What choices do I have regarding my information 	I do not know what choices you have regarding your information 	A2EJ7U3TZAKROG
What is mobile banking 	I do not know what mobile banking is 	A2NI2HSU84PHJW
What do I do if I -LRB- or someone I work with -RRB- gets hurt on the job . What do I need to do for workers ' compensation 	I do not know what you need for worker 's compensation 	A1HLG5NN2I16GN
How do we get to the museum 	I do not know how to get to the museum 	A3U6CLX7HD0SMF
How do I close down the account for a deceased relative 	I do not know how to close down the account for a deceased relative 	A9LX66EQWDRQ5	
Will the store be open on Easter 	I do not know if the store will be open on Easter 	A3GNQDFPZALU92	
What are the current ticket prices 	I do not know what are the current ticket prices 	A3SS1F4F3JE7CU
Is state income tax withholding on supplemental wages handled differently than withholding on regular wages 	I do not know IF state income tax withholding on supplemental wages ARE handled differently than withholding on regular wages	ATQD23E8ESFSI
I purchased a rental property last year . What closing costs can I deduct 	I do not know what closing costs you can deduct 	A2VFX3J4B1I22X
May I terminate an employee for a safety violation 	I am not able to terminate an employee for a safety violation 	A3RD486RQUI2XV
Can I pay with check or cash 	I do not know if you can pay with cash or check 	A2NI2HSU84PHJW
Is there an ATM on site 	I do not know if there is an ATM on site 	A3I9FTHSULHPYS
Please help me track my shipping 	I am not able to track your shipping 	A9LX66EQWDRQ5	
Is there a parking area close to the Chichu Art Museum 	I do not know if there is a parking area close to the Chichu Art Museum 	A1YB6WRWEXG1OC
Where can I have a work of art cleaned or conserved 	I do not know where you can have a work of art cleaned or conserved 	A2K9PB0U45O0MU
What are the requirements for the third-country national -LRB- non-EEA national -RRB- spouse of a Hungarian citizen or an EEA national to stay in the territory of Hungary for over three months 	I do not know what the requirements are for a non citizen spouse to stay in Hungary for over three months 	A1F46RJTOXQM4J
Are expressions supported for partition and partition-sort keys 	I do not know if expressions are supported for partition and partition-sort keys	A23CTGXNDDW5LC
How many visitors can I have in my room 	I do not know how many visitors you can have in your room 	A5VBIZ2KIQ1R8
Your website is showing two different prices for the item I 'd like to purchase 	I do not know why our website is showing two different prices for the item you 'd like to purchase 	AYJGJAIY0EXW
How many animals are at the Maryland Zoo 	I do not know how many animals are at the Maryland Zoo 	AT7ADQKXKXEWY
What are the Healey brothers parking lot guidelines	I do not know the Healy Brothers parking lot guidelines 	A8O98QNRG9SHV
How do I get software license keys for my machine 	I do not know how you get software license keys for your machine 	A1JBSFXMMRGSQD
What if I have moved since taking the test 	I do not know what you should do if you 've moved since taking the test 	A13GUTDMGGZZDL
Do you have any more related products 	I do not know if we have any more related products 	A31A4YKVSOYRVS	
Is there a way to expedite shipping 	I do not know how to expedite shipping 	A1HQRT1UG6ERGL
How often will the opportunity be provided to convert / open election periods 	I do not know how often the opportunity is provided to convert open election periods 	A2NI2HSU84PHJW
Do I need to file a claim with my insurance 	I do not know if you need to file a claim 	A325WS381BHOHH	
How much does parking cost and where do I pay 	I do not know how much parking costs , or where you pay 	AT7ADQKXKXEWY
Can I customize the color of my order 	I do not know if you can customize the color 	A1F04SJJSSWA1N
What is meant by ' no tax liability ' in the exceptions to the estimated tax penalty 	I am not able to tell you what ' no tax liability ' means in the exceptions to the estimated tax penalty 	AT7ADQKXKXEWY
Why should I bundle 	I do not know why you should bundle 	A1AF392CLGHH0X
Could you take our appetizer off of our bill 	I am not able to take an appetizer off your bill 	A113OGTB578EF6	
How do I give work to the Museum 's collection 	I do not know how you give work to the Museum 's collection 	A3U0VQ420HIMQ0
What types of people are selected as Fellows 	I do not know what types of people are selected as Fellows 	A1R1J3GL0YP7DJ
Is there a weight limit on my order 	I do not know if there is a weight limit on your order 	A31A4YKVSOYRVS	
How do I apply for a job with the National Park Service 	I do not know how you can apply for a job with the National Park Service 	A3G2FBKYCRD5Q8
I forgot my password 	I do not know your password	A23CTGXNDDW5LC
What should I say in my request 	I do not know what you should say in your request 	A1J0GU26323WVA
What should my camper bring 	I do not know what your camper should bring	A3NZLRU95OULXB
I need to extend my stay by one day	I am not able to extend your stay by one day	A23CTGXNDDW5LC
Should my son take dance 	I do not know if your son should take dance 	A27MJOV91GA8R3
How does your return policy work 	I do not know how our return policy works 	A260AFDCSXBQOH
How much is the registration fee 	I do not know how much the registration fee is 	A5VBIZ2KIQ1R8
Can I stop receiving my payroll advice in the mail since my check is direct deposited 	I do not know if that payroll advice sent to your mailbox can be stopped ,	A13JQTLPWXZD6L
There is no showroom where I live . Can I still purchase a system and meet with a design consultant 	I do not know if you can still purchase a system and meet with a design consultant 	A8O98QNRG9SHV
Is Jazz , Tap , Hip Hop , Ballroom , or Dance Team offered 	I do not know if Jazz , Tap , Hip Hop , Ballroom , or Dance Team are offered	A1GNG0J27JYSUB
Do you make exceptions to your return policy 	I am not able to make exceptions to our return policy 	AE9M4Z1NCYSDM	
Is the library at the Stedelijk accessible 	I do not know if the library at the Stedelijk is accessible 	ARKAJ6PL85CME
I 'd like to own a See 's franchise . How do I get started 	I do not know how you get started	A23CTGXNDDW5LC
How can I gift this to my brother 	I do not know how you can gift this to your brother 	A398I2WV28FA5P	
What if the weather is bad 	I do not know what the weather will be 	A2QWVKYC4RSJKM
What is my ' UltraViolet Library ' 	I do not know what UltraViolet Library is 	A234VIHHUHPZG5
Can I use united.com check-in when I have bags to check 	I do not know if you can use united.com to check-in when you have bags 	A9A2IX3OBORBE
What should I be careful of when buying tea 	I do not know what you should be careful of when buying tea 	AU3WB2DD4QJ4B
Do you know when the newest model is coming out after this item 	I am not able to tell you when the newest model is coming out after this item 	AE9M4Z1NCYSDM	
Do I have to provide a deposit if I was in an accident and it was n't my fault 	I do not know if you must provide a deposit if you were in an accident that was n't your fault 	A3SSJNH5SIZUPG	
Why is there an additional charge on my bill 	I do not know why there is an additional charge on your bill 	A1J0GU26323WVA	
Can you include a catalog with the new shipment 	I am not able to include a catalog with the new shipment 	A1D9EH4NAAP40N
Can I have my order shipped to two different locations 	I do not know if you can have your order shipped to two different locations 	A2IXBTOWQRCLPZ	
What do I do about a late package 	I do not know what you do about a late package 	AD9O852KPYLHY	
Do you have a nearby retail location that I can visit 	I do not know if we have a nearby retail location that you can visit 	A9LX66EQWDRQ5	
What information should be included in a succession plan 	I do not know what information should be included in a succession plan 	A3RD486RQUI2XV
Do you offer fundraising opportunities 	I do not know if we offer fundraising opportunities 	A3G2FBKYCRD5Q8
What is the status of the DVM Program 	I am not able to check the status of the DVM Program 	ALXPXFJ81RYE4
Can I return or exchange my lawn pass	I do not know if you can return or Exchange Your Lawn Pass	ATQD23E8ESFSI
Where can I find out about Harvard events 	I do not know where you can find out about Harvard events 	A16VTK6KZ1U69H
How does product A differ from product B 	I do not know how product A differs from product B	AD9O852KPYLHY	
I need to file a complaint about the associate I spoke with 	I am not able to file a complaint about an associate 	AD9O852KPYLHY	
Will the Centers be accessible to people with disabilities 	I do not know if the Centers will be accessible to people with disabilities 	A235UQRA8GE18X
Why do I have to list everyone by name on the card	I do not know why you have to list everyone by name on the card 	A3GVKU8KSX3RZU
When can I expect my invitation and how will it be sent 	I do not know when you can expect your invitation or how it will be sent 	A3I9FTHSULHPYS
How do I find information on encounters 	I do not know how you find information on encounters 	A7SXWHGK8B40R
Do you offer expedited shipping 	I do not know if expedited shipping is offered 	A2NI2HSU84PHJW
May I use a P.O. box in my mailing address 	I do not know if you may use your P.O. box in your mailing address 	A1JBSFXMMRGSQD
What are the benefits of direct deposit for me 	I do not know the benefits of direct deposit 	A1XNCA1SVTT15B
Is there an early departure fee 	I do not know if there is an early departure fee 	A3I9FTHSULHPYS
What should I wear to Meet Me At The Barre 	I do not know what should be worn to Meet Me At The Barre 	A2NI2HSU84PHJW
Is there parking at your location	I do not know if there is parking at our location 	A3U0VQ420HIMQ0
What are your Group Prices 	I do not know what the group prices are 	A2NI2HSU84PHJW
When do I have to give someone a privacy notice 	I do not know when to give someone a privacy notice 	ARFQ8FJRKCUZ6
What do I do if I need to access Workday to view or change my information but do n't have a computer 	I do not know if you need to access Workday to view or change your information if you do n't have a computer 	A2UBEPT605E8T2
How do I sync my zoozil account across multiple devices	I do not know how you sync your Zoozil account across multiple devices 	A2HKTM4Z8652
What Kind of Lessons Can I Expect 	I do not know what Kind of Lessons you Can Expect 	A3NZLRU95OULXB
What time does the waterpark open 	I do not know what time the waterpark opens 	A2CEGV4ZIZWRKY	
How does ED define a ' comparable program of study ' when considering eligibility for a closed school loan discharge 	I do not know ED defines a ' comparable program of study ' when considering eligibility for a closed school loan discharge 	A2K9PB0U45O0MU
What 's my order number	I do not know what your order number is 	A9LX66EQWDRQ5	
Links to your site from other sites are not working ; who do I contact 	I do not know who you contact 	A298FAWY76NZA9
What are the effective dates of FDAAA and the NIH Policy 	I do not know the effective dates of the FDAAA and NIH Policy 	A2NI2HSU84PHJW
Where can I find nutritional information about food sold at the Zoo 	I do not know where you can find information about food sold at the Zoo 	AU3WB2DD4QJ4B
Where do I find my Office product key 	I do not know where you find your Office product key 	A2K9PB0U45O0MU
How much is a subscription	I do not know how much a subscription is 	A9LX66EQWDRQ5	
Do you ship out orders the same day 	I do not know if we ship out orders the same day 	A2TKHXY755FAM
How do I switch my electrical service to my new address 	I am not able to tell you how you switch your electrical service to your new address 	A31A4YKVSOYRVS	
Can you please add me to your mailing list 	I am not able to add you to our mailing list 	A9LX66EQWDRQ5	
Where can I read on the warranty of my product 	I do not know where you can read the warranty of a product 	AJQGWGESKQT4Y
How much do the dances cost and can anyone come 	I do not know how much the dances cost and I do not know if anyone can come 	ARKAJ6PL85CME
What about training one of my current staff members 	I do not know about training 	A1DWQO9X2ZQ35G
Can you tell me the name of the service agent that specializes in this situation 	I am not able to tell you the name of the service agent that specializes in this situation	APF1EAZT104LQ
Do I have to be a dance major to take classes 	I do not know if you have to be a dance major to take classes	A23CTGXNDDW5LC
What is the usual process for when my product is lost during shipping 	I do not know what the usual process is when your product is lost during shipping 	A2H52PSYM32MG5	
Do you have a line of products for very elderly people 	I do not know if we have a line of products for very elderly people 	AE9M4Z1NCYSDM	
Can I try out a commercial template before I buy 	I do not know if you can try out a commercial template before you buy 	A3U0VQ420HIMQ0
When is the next generation going to be available for purchase 	I do not know when the next generation is going to be available 	A260AFDCSXBQOH
How can I obtain images of the exhibitions 	I do not know how you can obtain images of the exhibitions 	AZLZA0Q87TJZO
When does my gift card expire	I do not know when your gift card expires 	AJNQ2PBD07FKE
Can I get insurance for my kids under Obamacare and pay the tax for myself 	I do not know if you can get insurance for your kids under Obamacare and pay the tax for yourself 	A2VIKCIM9TZL22
What will I be seeing at the Vatican 	I do not know what you will be seeing at the Vatican 	AZLZA0Q87TJZO
What health care services are included on my new UVA Health System statement 	I do not know what health care services are included on your new UVA Health System statement 	A2D0IIX70FDQIW
When does my service request get filled 	I do not know when your service request gets fulfilled	A23CTGXNDDW5LC	
How long is the warranty good for 	I do not know how long the warranty is good for 	A9LX66EQWDRQ5	
May an employer withhold payment for unused paid vacation days as part of a mass layoff or plant closing 	I do not know if an employer can withhold payment for unused paid vacation days as part of a mass layoff or plant closing 	A8O98QNRG9SHV
Who is required to have a CDL in Texas 	I do not know who is required to have a CDL 	A13GUTDMGGZZDL
I bought a couple of things right now , checked out , but realized I forgot a couple of things and am wondering if I can add them to my order 	I am not able to add the things that you forgot to your order 	AMELZJ4P3IIJH
How long have I been a costumer here 	I do not know how long you have been a customer here 	A31A4YKVSOYRVS	
How do I take public transit to the Toronto Zoo 	I do not know how you take public transit to the Toronto Zoo 	A7SXWHGK8B40R
What is considered protected concerted activity under the National Labor Relations Act -LRB- NLRA -RRB- 	I do not know what is considered protected concerted activity under the National Labor Relations Act -LRB- NLRA -RRB- 	AJ7E01X4TAGHL
Can I check my account balance 	I am not able to check your account balance	A31A4YKVSOYRVS	
I need to verify that you have my correct phone number 	I am not able to verify if we have the correct phone number 	A3VV5FFG6GXE1S	
What is a practica 	I do not know what a practica is 	A2VIKCIM9TZL22
Who is eligible to serve as a juror in DeKalb County 	I do not know the eligibility for jurors in DeKalb County 	A1JWNZLD7PS5NU
What is my serial number to track the item online 	I do not know what your serial number is 	A325WS381BHOHH	
How do I get a claim form 	I do not know how to get a claim form 	A2EJ7U3TZAKROG
If I am a member , but am not able to visit Bishop Museum , can my children come without me 	I do not know if your children can come without you 	A2NI2HSU84PHJW
Do we have a restaurant or caf√© and if not what are the nearest ' nice ' places to eat 	I do not know if we have a restaurant or cafe , or what the nearest nice places to eat are 	A2K2MFQMN31DZ
Can I still buy tickets online 	I do not know if you can still buy tickets online 	A13GUTDMGGZZDL
I am out of shape . Do I need to lose weight before I try a Barre workout 	I do not know if you need to lose weight before you try a barre workout 	A2NI2HSU84PHJW
What locations are open	I do not know what locations are open 	A3MBQX8F0IZO7S
Where do I find the breakdown of this months bill 	I do not know where you find the breakdown of this month 's bill 	A3GNQDFPZALU92	
Can I buy extra insurance on the product 	I do not know if you can buy extra insurance on the product 	A3U6CLX7HD0SMF	
Can my school get a discount through your supply store 	I do not know if your school can get a discount through our supply store	A23CTGXNDDW5LC
How do I check on the status of my mortgage application 	I do not know how to check on the status of a mortgage application 	A3SSJNH5SIZUPG	
How do I qualify for this plan instead of the first one 	I do not know how you would qualify for this plan instead of the first one 	A30YFEIPGXNWJL
Can I add extra one-time purchases items onto my monthly subscription 	I am not able to add extra one-time purchase items on to your monthly order 	A3RD486RQUI2XV
Could I get a refund 	I do not know if you could get a refund 	A1J0GU26323WVA	
What happens if I 'm selected by the hiring department 	I do not know what happens if you are selected by the hiring department 	A1L1IRHUNKLN01
What do I do when I arrive at Alexandria Zoo 	I do not know what you do when you arrive at Alexandria Zoo 	AF8KEA2127EAN
Do you have lockers for storing bags/coats/belongings 	I do not know if we have lockers for storing belongings 	A9LX66EQWDRQ5
Do I have the option for a closed school loan discharge 	I do not know if you have the option for a closed school loan discharge 	A3R71HP45TBQ7O
I forgot my password or user name -- what do I do 	I do not know what you should do	APF1EAZT104LQ
How secure are my credit card and other personal details 	I do not know how secure your credit card and other personal details are 	A2K9PB0U45O0MU
What are the admission rates 	I do not know the admission rates 	A1J0GU26323WVA
Can I have a free upgrade 	I do not know if you can get a free upgrade 	AE9M4Z1NCYSDM	
I am a NYC school teacher or camp counselor . What is the admissions fee for my students/campers	I do not know the price of admissions fee for your students/campers 	A2K9PB0U45O0MU
How long will it take for the refund to hit my account 	I do not know how long it will take for the refund to hit your account 	A1GAARR4GOOZCO	
How do I opt-out of or cancel an insurance plan 	I do not know how to opt-out or cancel an insurance plan 	A10249252O9I20MRSOBVF
Should I take group classes or private lessons 	I do not know if you should take group classes or private lessons 	A3G2FBKYCRD5Q8
Do you honor coupons 	I do not know if we honor coupons 	A31A4YKVSOYRVS	
What type of attachments may be added to an application package 	I do not know what type of attachments may be added to an application package 	A3U0VQ420HIMQ0
How do I plan a visit to the Memorial 	I do not know how you plan a visit to the Memorial 	A2HKTM4Z8652
What information should an employer provide to its employees about its succession planning process 	I do not know What information an employer should provide to its employees about its succession planning process	ATQD23E8ESFSI
What if my change will impact my amount due 	I do not know if your change will impact the amount due 	A2NI2HSU84PHJW
What kind of new products do you have 	I do not know what new products there are 	A1HQRT1UG6ERGL
What is your method of payment 	I do not know which method 	A1DWQO9X2ZQ35G
Can registration and results information be uploaded electronically to ClinicalTrials.gov 	I do not know if registration and results information can be uploaded electronically to ClinicalTrials.gov 	A3R71HP45TBQ7O
What is replacement planning 	I do not know replacement planning 	A2NI2HSU84PHJW
What is the admission charge 	I do not know the admission charge 	A1RVRBKEQL1ZPG
Is there a permanent collection at the Museum 	I do not know if there is a permanent collection at the Museum 	A1YB6WRWEXG1OC
How can I change or cancel my group reservation 	I do not know how to change or cancel your group reservation 	A9LX66EQWDRQ5
How much will taxes cost on my order 	I do not know how much taxes will cost on your order 	A185P3B2MC2K83
Can you tell me when my order will be shipped 	I am not able to tell you when your order will be shipped	A23CTGXNDDW5LC
What is group therapy like	I do not know what group therapy is like 	A30YFEIPGXNWJL
How can I pay for my course fees 	I do not know how you can pay for your course fees 	A2EJ7U3TZAKROG
Does the Zoo have a reciprocal agreements with other institutions 	I do not know if the Zoo has reciprocal agreements with other institutions 	A2NI2HSU84PHJW
How do I purchase a gift membership 	I do not know how you purchase a gift membership 	A1AF392CLGHH0X
Why is n't my photo showing in Self Service 	I do not know why your photo is n't showing in self service 	A3RD486RQUI2XV
What language do I need to apply in 	I do not know What language you need to apply in	A3NHJPE6326P9V
What is the average Footprint for someone in my country 	I do not know the average Footprint for someone in your country 	APC99TPURUHR8
I need to set up auto pay 	I am not able to set up auto play 	A113OGTB578EF6	
Can you please verify my tracking number	I am not able to verify your tracking number 	A9LX66EQWDRQ5	
Do you allow outside food & drink or coolers 	I do not know if we allow outside food & drink or coolers 	A1XNCA1SVTT15B
Do I have to specify the date I am visiting when purchasing tickets online	I do not know if you have to specify the date you are visiting when purchasing tickets online 	A3I9FTHSULHPYS
Can you please cancel my order 	I am not able to cancel your order	A23CTGXNDDW5LC	
Why Audience of One Dance 	I do not know the audience of one dance 	A3722NOMVUK89T
Can I switch to another carrier without paying an Early Termination Fee before my service transitions to AT&T 	I do not know if you can switch to another carrier without paying an Early Termination Fee before your service transitions to AT&T 	A7SXWHGK8B40R
Do you offer a military discount 	I do not know if we offer a military discount 	A2NI2HSU84PHJW
I hear there is a security interview before my flight 	I am not able to tell you if there is a security interview before the flight	APF1EAZT104LQ
Is there anywhere to eat and drink 	I do not know if there is anywhere to eat and drink 	A1X3SF2W1QQBY1
How do I apply for your store 's credit card 	I do not know how you apply for our store 's credit card 	A31A4YKVSOYRVS	
How will I know if a position has been closed or cancelled 	I do not know if a position will be closed or cancelled	A23OS0HQ12VVOR
What Is The Membership Renewal Process 	I do not know what the membership renewal process is	A1CMT9MVUO52VP
What can I expect for my driving test 	I do not know what you can expect for your driving test 	A7SXWHGK8B40R
What if my ex-spouse is named as my beneficiary 	I do not know what to do if your ex-spouse is named as your benificiary 	APC99TPURUHR8
Do you have to be a Cabinet officer to attend a Cabinet meeting 	I do not know if you have to be a Cabinet officer to attend a Cabinet meeting 	A2EJ7U3TZAKROG
In which languages is the audio tour available 	I do not know which languages the audio tour is available in 	A2K9PB0U45O0MU
My item was on sale when I bought it , can I still return it 	I do not know if you can still return the item you bought on sale 	A1JBSFXMMRGSQD
How big of an issue is it if someone comes into the theater and breaks the no-food rule 	I do not know how big of an issue it is if someone comes into the theater and breaks the no-food rule 	A1GAARR4GOOZCO	
Is there a nursing room 	I do not know if there is a nursing room 	A9LX66EQWDRQ5
I was just married and would like to get my profile name changed 	I do not know how to change your profile name 	ASFR82SJYMGNU
I received my order today but it was broken , what can I do to remedy this 	I am not able to remedy your order 	AJNQ2PBD07FKE
Can my membership be shared with a caregiver or other family member 	I do not know if your membership can be shared 	A298FAWY76NZA9
Are you able to forward me to your manager 	I am not able to forward you to my manager 	A3UJSDFJ9LBQ6Z
Does the website offer function for the hearing impaired 	I do not know if the website offers function for the hearing impaired 	A31A4YKVSOYRVS	
How do I donate to the Museum 	I do not know how you donate to the museum 	A13GUTDMGGZZDL
How is federal recognition status conferred 	I do not know how federal recognition status is conferred 	A7SXWHGK8B40R
What is Blue Star Museums 	I do not know Blue Star Museums 	A3V37YH9NLG6PD
Why am I missing some search filters 	I do not know why you are missing some search filters 	A7SXWHGK8B40R
How do I reset my password 	I do not know how you reset your password	A23CTGXNDDW5LC	
Can I receive a refund for my membership 	I do not know if you can receive a refund for your membership 	A1JBSFXMMRGSQD
Is a stepparent eligible to be the caretaker for an applicant age 14-21 	I do not know if a stepparent is eligible to be the caretaker for an applicant age 14-21 	A1R1J3GL0YP7DJ
Can I confirm my flight over the phone 	I am not able to confirm your flight over the phone 	A3GNQDFPZALU92	
Do you offer student discounts on your software 	I do not know if we offer student discounts on our software 	A3VV5FFG6GXE1S	
How should an employer classify assistant managers and other managers who perform significant amounts of nonexempt work 	I do not know how an employer should classify assistant managers and other managers who perform significant amounts of nonexempt work 	A2HKTM4Z8652
How much time does it take to get around the Zoo 	I do not know how much time it takes to get around the Zoo 	ARKAJ6PL85CME
What kinds of cases are heard in City Court of Slidell 	I do not know what kinds of cases are heard 	A325WS381BHOHH
Are there any special exhibits 	I do not know if there are any special exhibits 	A2VIKCIM9TZL22
How is my medical information protected 	I do not know how your medical information is protected 	A3G2FBKYCRD5Q8
Where do the buildings connect 	I do not know where the buildings connect 	A13GUTDMGGZZDL
Can I bring my bike/scooter/skate boards into the Zoo 	I do not know if you can bring your bike/scooter/skate boards into the Zoo 	A3R71HP45TBQ7O
What methods of payment can I use online 	I do not know what methods of payments you can use online 	A8O98QNRG9SHV
Where is the Members ' Cloakroom 	I do not know where the Members ' Cloakroom is 	A7SXWHGK8B40R
How do I purchase an upgrade 	I do not know how you would purchase an upgrade	A3LNWUYXJH1EUC
Who is your claims rep in Montana 	I do not know who our claims rep in Montana is 	A325WS381BHOHH	
What are the objectives of the Awards and Recognition Programs 	I do not know The objectives of the Awards and Recognition Programs	ATQD23E8ESFSI
Are DivX Certified devices required to support DivX DRM 	I do not know if DivX Certified devices are required to support DivX DRM 	A16VTK6KZ1U69H
What is the difference between these products 	I do not know the difference between these products 	A2C3I4DWGVPA1O
Can you please tell me how to return my package 	I am not able to tell you how to return your package	A23CTGXNDDW5LC	
I understand the value of bringing heat down in the winter , but what 's the point of mixing that warmer air in the summer	I do not know what 's the point of mixing that warmer air in the summer 	A3B2YRXL26RPVH
What benefits do I receive 	I do not know what benefits you receive 	A2RHBR7XZGUI1C
What is a Labor Management Committee 	I do not know what a Labor Management Committee is 	A3RD486RQUI2XV
What is the best way into The Zoo Amphitheatre and where can I park 	I do not know the best way into The Zoo Amphitheatre or where you can park 	A2K9PB0U45O0MU
Why am I being notified about jobs I did n't indicate as an interest in my profile 	I do not know why you are being notified about jobs you did n't indicate as an interest in your profile 	A2K9PB0U45O0MU
What colors is that available in 	I do not know what colors it is available in 	AXY0D2AMLKE2A
I want to collect the item at your warehouse is that possible 	I do not know if you can collect it at our warehouse 	A113OGTB578EF6	
Can I get a discount for being a loyal customer 	I do not know if you can get a discount for being a loyal customer 	AD9O852KPYLHY	
Do you have a wedding chapel 	I do not know if we have a wedding chapel 	A3I9FTHSULHPYS
I forgot to clock in/out how do I fix my time 	I do not know how you can fix your time 	A16NITTBMCSN0V
Why ca n't I use the 20 % code Spring56 on my order 	I do not know why you ca n't use the 20 % code Spring56 on your order 	A31A4YKVSOYRVS	
Are there fun/games for kids 	I do not know if there are fun/games for kids 	AZLZA0Q87TJZO
The chair I want is out of stock , how do I find out when it will be coming back in stock 	I do not know how you find out when the chair you want will be coming back in stock 	A1X3SF2W1QQBY1
What are the risks for employers in relying on employee referrals and other word-of-mouth recommendations when seeking to fill vacant positions 	I do not know what the risks are for employers in relying on employee referrals and other word-of-mouth recommendations when seeking to fill vacant positions 	A1JBSFXMMRGSQD
I received my order but one of my items was missing , could you look in to this 	I am not able to look into the missing item 	A31A4YKVSOYRVS	
What courses does Harvard offer 	I do not know what courses Harvard offers 	A3U0VQ420HIMQ0
I found a beautiful shirt but I was wondering if I could put in a request for a bigger size and different color 	I do not know if you can put in a request for a bigger size and different color for the shirt that you found 	A1GAARR4GOOZCO	
What languages is the tour in 	I do not know what languages the tour is in 	A3RD486RQUI2XV
Why do the client programs say Driver not connected when I try to run them 	I do not know why client programs say Driver not connected	APF1EAZT104LQ
Who are the teachers 	I do not know who the teachers are 	A2UBEPT605E8T2
After my subscription expires , can I download update packages of ZT Stuff 	I do not know if you can download update packages of ZT stuff after your subscription expires 	ABWW1P7GZ4C0Z
Could you get me a size 4 instead of a size 6 	I am not able to get you a size 4 instead of a size 6 	A9LX66EQWDRQ5	
What should I do if I do not come to work 	I do not know what you should do if you do not come to work 	A2HKTM4Z8652
Can I unsubscribe from promotional emails	I am not able to unsubscribe you from promotional emails	AQ64IKQFVU0BF
What are the matinee show times 	I do not know what the matinee show times are 	AZLZA0Q87TJZO
How should an employer cut through ' canned interview responses ' to get the information it really needs 	I do not know how an employer would cut through ' canned interview responses ' in order to get the information it needs 	A2VIKCIM9TZL22
I am due to retire on or after 1 January 2018 at age 60 or 62 . Under the ICSC compensation package , the mandatory age of retirement for all staff members on board as of 1 January 2018 will be 65 . Will I be eligible for the continuing appointment now that I will have 7 years remaining from the eligibility date until I turn 65 	I do not know if you are eligible for the continuing appointment now that you will have 7 years remaining from the eligibility date until you turn 65 	A3SS1F4F3JE7CU
Can I get extra procentage of if the item is damaged 	I do not know if you can get extra procentage if the item is damaged 	A31A4YKVSOYRVS	
The users of my UltraViolet Library are no longer together . How do I divide the movies and TV shows that are in the Library 	I do not know how you can divide the movies and TV shows that are in the Library 	A8O98QNRG9SHV
Which financial analysts follow Cognizant 	I do not know which financial analysts follow Cognizant 	A1XNCA1SVTT15B
How does a hospital register for the Medicaid EHR Incentive Program 	I do not know how a hospital registers for the Medicaid EHR Incentive Program 	AQ9Y6WD8O72ZC
Where can I get copies of the Human Resources Forms 	I do not know where you can get copies of the Human Resources Form 	A2EJ7U3TZAKROG
How do I free up space on my tablet 	I do not know how you free up space on your tablet	A23CTGXNDDW5LC	
Is there a special shipping cost for Hawaii 	I do not know if there is a special shipping cost for Hawaii 	A1JBSFXMMRGSQD
Which regulations describe the HUBZone program 	I do not know which regulations describe the HUBZone program 	AZLZA0Q87TJZO
Where is this product made 	I do not know where this product is made 	AD9O852KPYLHY	
Is there a limit to the amount of calls I can make with Robo-Dialer 	I do not know if there is a limit to the amount of calls you can make with Robo-Dialer 	A2LQ9NP944M61Z
How many Unions do we have on campus 	I am not able to tell you how many unions are on campus	APF1EAZT104LQ
Do you offer a senior discount 	I do not know if we offer a senior discount 	A3U6CLX7HD0SMF	
I would like to create a registry on your website 	I am not able to create a registry on our website for you 	A1JBSFXMMRGSQD
When am I eligible to audition for dance productions 	I do not know when you are eligible to audition for dance productions 	AC8ETQXPDRR6P
Do you offer any warranties 	I do not know IF we offer any warranties	ATQD23E8ESFSI
Before Camp : What should my camper bring to camp 	I do not know what your camper should bring to camp 	AZLZA0Q87TJZO
What if my child has allergies 	I do not know if your child has allergies 	A2NI2HSU84PHJW
Is there something to do for children who do n't know how to walk yet 	I do not know if there is something to do for children who do n't know how to walk yet 	A3R71HP45TBQ7O
Do the adults who are driving have to pay for parking 	I do not know if the adults who are driving have to pay for parking 	A3G2FBKYCRD5Q8
What is ' Lyrical ' dance 	I do not know what ' Lyrical ' dance is 	A1JBSFXMMRGSQD
Can I have two contact numbers on my account 	I do not know if you can have two contact numbers on your account 	A2YQAE441JMA7V	
Can I place an order 	I do not know if you can place an order 	A1YKWG46AWMPUX	
I have received an EOB from my insurance carrier , what do I need to do 	I do not know what you need to do 	A2NI2HSU84PHJW
I understand that networking is important at work , but I am fairly introverted . Any ideas 	I do not know if we have any ideas 	A7SXWHGK8B40R
Why is the pricing different for different nights 	I do not know why the pricing is different 	A13GUTDMGGZZDL
I recently had a baby , got married/divorced , had a dependent graduate from college , or my spouse/partner 's benefits changed at his/her employer . How can I make the appropriate changes to my benefit selections 	I do not know how you can make the appropriate changes to your benefit selections 	A2K9PB0U45O0MU
I 'm a member of the media and would like to arrange a zoo visit or take some photographs . Who should I contact	I do not know who you should contact to arrange a zoo vist or take some photographs for the media 	A1J0GU26323WVA
Does your website have any more of the orange sunglasses in stock 	I do not know if the website has any more of the orange sunglasses in stock 	AJ7MWBQFNH3E4
What kind shoes should I wear	I do not know what kind of shoes you should wear 	A116N2LEI6O7HB
Is it too late to add a note to my package 	I do not know if it is too late to add a note to your package 	A3U6CLX7HD0SMF	
What are some ways to protect outdoor workers from the heat 	I do not know what some ways are to protect outdoor workers from the heat 	A3RD486RQUI2XV
I 'm staying at a downtown hotel , but do n't have my car . How do I get to the Museum 	I do not know how you can get to the museum without a car 	A2K9PB0U45O0MU
I am planning to file an application with TTB for a permit or other approval to operate -LRB- such as a brewer 's notice -RRB- . Can I file the application although I 'm not quite ready to open for business 	I do not know if you can file the application	A3NHJPE6326P9V
What kind of cake is provided 	I do not know what kind of cake is provided 	A2K2MFQMN31DZ
Does the Museum offer any discounts 	I do not know if the Museum offers any discounts 	ARKAJ6PL85CME
Can I select which warehouse my inventory will be stored 	I do not know if you can select which warehouse your inventory will be stored 	A2NI2HSU84PHJW
Can you move my order to the front of the line 	I am not able to move your order to the front of the line	A23CTGXNDDW5LC
When purchasing tickets online , can I use these tickets any day 	I do not know when purchasing tickets online , if you can use these tickets any day 	A27MJOV91GA8R3
I want to visit the museum with a group of people ; do you offer a group discount 	I do not know if there are group discounts 	A2NI2HSU84PHJW
Do you donate to other non-profit auctions 	I do not know if we donate to other non-profit auctions 	A3MBQX8F0IZO7S
When will my shirt ship	I do not know when your shirt will ship 	A3GNQDFPZALU92	
There is a fraudulent charge on my bank statement . Can you please look into this 	I am not able to look into a fraudulent charge on your bank statement 	A325WS381BHOHH	
Are you looking for alternatives to can liners with BPA for Coca-Cola or other beverage cans 	I do not know if I am alternatives to can liners with BPA for Coca-Cola or other beverage cans 	A1J0GU26323WVA
Are social security survivor benefits for children considered taxable income 	I do not know if social security survivor benefits for children are considered taxable income 	AZLZA0Q87TJZO
Who operates the Virginia Zoo 	I do not know who operates the Virginia Zoo 	A16VTK6KZ1U69H
I have a current IT support company , but I am unhappy with their service . How can I transition to another IT service provider if my existing support is unwilling to cooperate during the switch 	I do not know how you can transition to another IT service provider if your existing support is unwilling to cooperate 	A8O98QNRG9SHV
Where can I eat on campus 	I do not know where you can eat on campus 	A1YUEWAWRZ590A
What is the date and time of Brew at the Zoo 	I do not know what date and time 	AQ2U7QPE229VH
Are pets allowed at the Getty Center 	I do not know if pets are allowed at the Getty Center	A23CTGXNDDW5LC
How may an employer enhance its methods of job evaluation 	I do not know how an employer may enhance its methods of job evaluation 	A7SXWHGK8B40R
Can I try this out before I buy it 	I do not know if you can try this out before you buy it	A23CTGXNDDW5LC
Q -- What is Gift Aid	I do not know what a gift aid is	APF1EAZT104LQ
I need a khaki shirt	I do not know if you need a khaki shirt	A23CTGXNDDW5LC	
How can I change my address 	I do not know how you can change your address 	A2HKTM4Z8652
If I move , will there be a delay in my subscription being forwarded 	I do not know if there will be a delay in your subscription being forwarded if you move 	A9LX66EQWDRQ5	
What type of print material goes along with the video lessons 	I do not know what type of print material goes along with the video lessons 	A2115OWJ0CKOB3
Once shipped can I track the item 	I do not know if you can trac the item 	A325WS381BHOHH	
cAN YOU HELP ME GET MY SHIPPING NUMBER 	I am not able to help you get your shipping number	A23CTGXNDDW5LC
What is OnStar ¬Æ 	I do not know what OnStar ¬Æ is 	A16VTK6KZ1U69H
Is it Ok to skip one monthly payment 	I do not know if it is OK to skip one monthly payment 	A2YQAE441JMA7V	
What is the current status of my account 	I am not able to check the current status of your account 	A3FIJGXCWIHHQ5	
As a biweekly-paid employee , how do I make retroactive corrections/additions to my time 	I do not know how you make retroactive corrections/additions to your time 	A3LVU39B5A9MNI
If an employee is out on vacation or on sick leave and then works hours outside his or her normal working schedule , must he or she be paid overtime 	I do not know if an employee must be paid overtime if he or she is out on vacation or on sick leave and then works hours outside his or her normal working schedule 	A3U0VQ420HIMQ0
What happens if my item breaks before the warranty period expires	I do not know what happens if your item breaks before the warranty period expires 	A1J0GU26323WVA
Can you help me order this as a gift for my grandma 	I am not able to help you order that as a gift for your grandma	AJ7MWBQFNH3E4
What privacy concerns should an employer be aware of when recruiting using social media 	I do not know what privacy concerns an employer should be aware of when recruiting using social media 	A2K9PB0U45O0MU
Can I return merchandise in the store if I ordered online 	I do not know if you can return merchandise in the store if you ordered online 	A3GNQDFPZALU92	
Can I change the date of order f or just this month , and have it continue regularly after 	I do not know if you can change the date of order for just this month , and have it continue regularly after 	A185P3B2MC2K83
Is there a coat check	I do not know if there is a coat check 	A1JBSFXMMRGSQD
Who can I talk directly to about a job I have applied for 	I do not know who you can talk to directly about a job you have applied for 	A1JBSFXMMRGSQD
Where and how do I get my child 's recital costume and what will it cost 	I do not know where and how you get your child 's recital costume and I do not know what it will cost 	A11IEP7J8XSE1C
I am allergic to feather products . Do you offer any hypoallergenic bedding	I do not know if we offer any hypoallergenic bedding 	APC99TPURUHR8
Why do we have to pay full tuition every month 	I do not know why you have to pay full tuition every month 	A1J0GU26323WVA
What is current market value and how is it determined 	I do not know what the current market value is and how it is determined 	A2RHBR7XZGUI1C
Are elected officials required to take training on the Freedom of Access Act 	I do not know if elected officials are required to take training on the Freedom of Access Act 	A3B2YRXL26RPVH
What if my tree does n't seem to be absorbing water in the stand 	I do not know why your tree does n't absorb water in the stand 	ALDKJ42AAASLI
What if I have extra wristbands 	I do not know what happens if you have extra wristbands 	A2K2MFQMN31DZ
Do you have any special hours for holidays 	I do not know if there are special hours for holidays 	A260AFDCSXBQOH
Which international channels are available with this satellite service 	I do not know which international channels are available with this satellite service 	ARCNENCVA0STW	
Is a terminated employee eligible for unemployment 	I do not know if a terminated employee is eligible for unemployment 	A7SXWHGK8B40R
Is CMA accessible for special needs 	I do not know if CMA is accessible for special needs 	A1J0GU26323WVA
Can you please tell me what my current deductible is 	I am not able to tell you what your current deductible is 	A1J17BE20G6DKA
Is the refund for a return 100 % 	I do not know if the refund for a return is 100 % 	A3VV5FFG6GXE1S	
What is the official name of M√©xico 	I do not know what the official name of M√©xico is 	A2VIKCIM9TZL22
how many fish species are there 	I do not know how many fish species are there 	A7SXWHGK8B40R
I am beginner dancing for the first time , Am I able to participate in class 	I do not know if you are able to participate in class since you are a beginner dancing for the first time 	A1J0GU26323WVA
How much does it cost to upgrade an existing Membership , and does my expiration date change 	I do not know about the cost to upgrade your membership , nor do I know if it will change your expiration date 	A1F46RJTOXQM4J
When will my debit card arrive in the mail 	I do not know when your debit card will arrive in the mail 	A9LX66EQWDRQ5	
How do I learn about events at the Art Museum 	I do not know how you learn about events at the Art Museum 	A2HKTM4Z8652
How do I go about making a return	I do not know how you would go about making a return 	A3RD486RQUI2XV
Are there hiking trails at the zoo 	I do not know if there are hiking trails at the zoo 	ARKAJ6PL85CME
I want to have a chat with your superior 	I am not able to have a chat with my superior	A23CTGXNDDW5LC
Do I have to bring my printed ticket to the event 	I do not know if you have to bring your printed ticket to the event 	AFS36YMNN8A2J
Has Treasury ever redeemed existing investments and suspended new investments in the CSRDF before 	I do not know if the Treasury ever redeemed existing investments and suspended new investments in the CSRDF before 	A3RO0QIXW4IX3Y
what 's the warmest jacket you have here 	I do not know what the warmest jacket we have is 	A1J0GU26323WVA	
how long does order processing usually take	I do not know how long processing will take 	AEXWOFM1LGS6U
Why do I have to show a photo ID each time I visit 	I do not know why do you have to show a photo ID each time you visit 	A3SS1F4F3JE7CU
Is there a suggested route for visitors 	I do not know if there is a suggested route for visitors 	A3G2FBKYCRD5Q8
Can I add items to an order I just placed 	I do not know if you can add items to an order you just placed 	AE9M4Z1NCYSDM	
How long are eTickets valid 	I do not know how long eTickets are valid 	A1JBSFXMMRGSQD
Is there a FAQ located anywhere on your website 	I do not know if there is a FAQ located anywhere on our website 	A3RD486RQUI2XV
Do you sell floor mats 	I do not know if we sell floor mats 	A9LX66EQWDRQ5	
Are agents available after 5 pm 	I do not know if agents are available after 5 pm 	A1OPGPTQJ48XOY	
Are there job descriptions available for Faculty and Adjunct positions 	I do not know if there are job descriptions available 	A13GUTDMGGZZDL
What kind of affirmative action requirements do employers with federal contracts have to meet for individuals with disabilities and veterans 	I do not know what kind of affirmative action requirements employers with federal contracts have to meet for individuals withe disabilities and verterans 	A2TP3K1THK6XRB
How can I email corporate 	I do not know how you can email corporate 	AGQPTDG6ZF3T3
Are there some sort of zoning laws or can I build it without a permit 	I am not able to help you with the zoning laws 	A3RD486RQUI2XV
I was thinking of ordering a large amount of product , can you give me a discount code 	I am not able to give you a discount code 	A30YFEIPGXNWJL
When will my annual leave category change 	I do not know when your annual leave category will change 	A2EJ7U3TZAKROG
What did David say to the Last Engineer 	I do not know what David said to the Last Engineer 	A2NI2HSU84PHJW
Does our offer of employment need to be in writing in order to conduct a ' post-offer ' criminal background check 	I do not know if your offer of employment needs to be in writing in order to conduct a ' post-offer ' criminal background check 	A8O98QNRG9SHV
Are there audio guides inside the museum 	I do not know if there are audio guides inside the museum 	A16VTK6KZ1U69H
Can I speak to a manager 	I do not know if you can speak to a manager	A23CTGXNDDW5LC
My supervisor has sent back my leave request for reworking -- what do I do now 	I do not know what you should do now 	A13GUTDMGGZZDL
Are employers ever legally obligated to conduct an internal investigation 	I do not know if employers are ever legally obligated to conduct an internal investigation 	A1BWNS27NA1JAP
Does this car come with an extended warranty 	I do not know if this car comes with an extended warranty 	A9LX66EQWDRQ5	
How do I fill out a Dreamlife Questionnaire 	I do not know the questionnaire 	A3722NOMVUK89T
Can I bring a camper van to the zoo 	I do not know if you can bring a camper van to the zoo 	A5VBIZ2KIQ1R8
Are there any special discounts going on right now 	I do not know if there are any special discounts going on right now 	A8F4B0854KTXO	
Is free return shipping offered 	I do not know if free return shipping is offered 	ASFR82SJYMGNU
Are all of your used cars inspected 	I do not know if they are inspected or not 	A13GUTDMGGZZDL
May I purchase a Lifetime membership to The Museum of Flight 	I do not know if you can purchase a lifetime membership to The Museum of Flight 	A3NZLRU95OULXB
I Do n't Have my Own Doctor . Will I be Cared for by a Hospitalist 	I do not know if you will be cared for by a Hospitalist 	A7SXWHGK8B40R
How soon will the insurance adjuster come out to look at the car 	I do not know how soon the insurance adjuster will come out to look at the car 	A3GNQDFPZALU92	
What are the age / document requirements for a driver license or ID 	I do not know what the age/document requirements are for a driver license or ID 	A3G2FBKYCRD5Q8
Are there any ongoing fees 	I do not know if there are any ongoing fees	A23CTGXNDDW5LC
Tell me about your teaching staff 	I am not able to tell you about our teaching staff	A23CTGXNDDW5LC
Are there video screens	I do not know if there are video screens 	A116N2LEI6O7HB
Can I use united.com Club deposits to pay for my taxes and fees for an award ticket -LRB- mileage redemption -RRB- 	I do not know if you can use United.com Club deposits to pay for your taxes and fees for an award ticket 	A2NI2HSU84PHJW
How often do you update your physical catalog 	I do not know how often we update our physical catalog	A23CTGXNDDW5LC
Someone from my family has donated an object to the Museum . Is it available for viewing 	I do not know if the item is available for viewing 	A2UBEPT605E8T2
Do you have any new products coming out next month 	I do not know if we have any new products coming out next month 	A3U6CLX7HD0SMF	
Is the ECOMUSEUM ZOO WHEELCHAIR accessible	I do not know if the ecomuseum zoo is wheelchair accessible 	APC99TPURUHR8
Do you carry Starter jackets	I do not know if we carry Starter jackets 	A3SSJNH5SIZUPG	
The product I received is not what I ordered . What do I need to do 	I do not know what you have to do to correct a situation where you received an incorrect order 	A1F04SJJSSWA1N
Is a nonexempt employee required to record or report his or her hours on a daily basis 	I do not know if a nonexempt employee is required to record or report his or her hours on a daily basis 	A8O98QNRG9SHV
I need to change the details for my credit card info 	I am not able to change the details of your credit card info 	AJKA9BKC011F2
Are you willing to send me a sample so I can test your product before committing to a large order 	I am not able to send you a sample	APF1EAZT104LQ
What shipping service do you use	I do not know what shipping service we use 	ASFR82SJYMGNU
Is an employer required to shred paperwork that contains personal information 	I do not know if an employer is required to shred paperwork that contains personal information 	A2I4VNAS21FXCE
Do you have anybody here who can help me with decorating designs for my home 	I do not know if we have anybody here who can help you with decorating designs for your home 	A325WS381BHOHH	
Why should I obtain IBMid 	I do not know why you should obtain IBMid 	A1X3SF2W1QQBY1
Can my family come with me during the move 	I do not know if your family can come with you 	A13GUTDMGGZZDL
Which years are associated with a particular Congress 	I do not know which years are associated with a particular Congress 	A2NI2HSU84PHJW
How quickly can E-TRAC transactions move through the approval process , from creator to second level approver 	I do not know how quickly E-TRAC transactions can move through the approval process , from creator to second level approver 	A11TABPKSVOOFT
Does MGM Grand offer parking for hotel guests 	I do not know if MGM Grand offers parking for hotel guests 	A3L8LSM7V7KX3T
Do members need to reserve tickets if they DO NOT wish to access the concert hall 	I do not know if members need to reserve tickets if they do not wish to access the concert hall 	A16VTK6KZ1U69H
Please show me some other options in this same or similar size and color	I am not able to show you other options 	A1YKWG46AWMPUX	
Why is there an admission charge 	I do not know why there is an admission charge 	A365NNKWZAZ2YV
I want the name on the package delivery changed 	I am not able to change the name on the package delivery 	A185P3B2MC2K83
How can my family and friends call me 	I do not know how your family and friends can call you 	A3R71HP45TBQ7O
Is there a law that requires food labels to list ingredients that commonly cause food allergies 	I do not know if there is such a law 	AOPI4DCPSO8H4
Why is TrueCar 's Factory Invoice often higher than the Invoice Price I see on other sites 	I do not know why TrueCar 's Factory Invoice is often higher than the Invoice price you see on other sites 	A2D0IIX70FDQIW
Do I need a reason to dismiss on notice	I do not know if you need a reason to dismiss on notice 	AJ7E01X4TAGHL
Is my company 's data secure 	I do not know if your company 's data is secure 	A1J0GU26323WVA
Will I have access to all of the available features in My Verizon 	I do not know if you will have access to all of the available features in My Verizon 	AJ7E01X4TAGHL
Does BAMPFA have a lost and found 	I do not know if they have a lost and found 	A13GUTDMGGZZDL
Is an employer required to allow an employee to telecommute because of the employee 's disability under the Americans With Disabilities Act -LRB- ADA -RRB- 	I am not able to tell you if an employer is required to do that	APF1EAZT104LQ
Is Chevrolet currently offering any incentives or Special Offers 	I do not know if Chevrolet is currently offering any incentives or Special Offers 	A1J0GU26323WVA
Can I get a discount because you do n't have what I wanted 	I am not able to give a discount because we do n't have what you wanted 	A1JBSFXMMRGSQD
Do I need Human Resources 	I do not know if you need Human Resources	A598UDLZZZAJ3
What if I did n't receive my confirmation email 	I do not know what to do if you did n't receive your confirmation email 	APC99TPURUHR8
Do you charge a fee for self-guided groups 	I do not know if there is a fee for self-guided groups 	A2VIKCIM9TZL22
How can I arrange for a return of an item I purchased 	I do not know how you can arrange for a return of an item you purchased 	A9LX66EQWDRQ5	
What payment forms do you accept 	I do not know What payment forms WE accept	ATQD23E8ESFSI
At what website address can I track the package 	I do not know what website address you can track the package at 	A325WS381BHOHH	
How do I know that my cancellation was successful 	I do not know how you would tell if your cancellation was successful 	A3RO0QIXW4IX3Y
What is the best way to clean my coffee grinder 	I do not know the best way to clean your coffee grinder 	A2NI2HSU84PHJW
Is an online map of the Museum available 	I do not know if an online map of the museum is available	A23CTGXNDDW5LC
How is a Cat 's Age Determined 	I do not know how a cat 's age is determined	A23CTGXNDDW5LC
What is the difference between Seasoned Steel and Seasoned Cast Iron 	I do not know the difference between Seasoned Steel and Seasoned Cast Iron 	A7SXWHGK8B40R
For large purchases , can I pay in installments	I do not know if you can pay in installments	A23CTGXNDDW5LC
Can you guys give me a pdf of your catalog 	I am not able to give you a pdf of our cataglog 	ASFR82SJYMGNU
Is it possible my order got mixed up with someone elses 	I do not know if it is possible your order got mixed up with someone elses	A23CTGXNDDW5LC
Can I include my in-cabin pet in my reservation 	I do not know if you can include your in-cabin pet in your reservation 	A7SXWHGK8B40R
Is my membership good for a calendar year , or for a full year from time of purchase 	I do not know if your membership is good for a calendar year , or for a full year from time of purchase 	A3I9FTHSULHPYS
What is the average size of dance classes at Point Park 	I do not know the average size of dance classes at Point Park 	A3SS1F4F3JE7CU
Can you expedite the shipping on my order 	I am not able to expedite the shipping on your order 	A3VV5FFG6GXE1S	
Can I get a quote on liability insurance 	I am not able to give you a quote on liability insurance	A8F4B0854KTXO	
Rebooking options if a schedule change has affected your itinerary	I do not know what the rebooking options are if a schedule change affects your itinerary 	A13GUTDMGGZZDL
Where can I locate care instructions on your website for a product I just purchased 	I do not know where on our website to locate care instructions for the product you just purchased 	AMELZJ4P3IIJH
Northwestern accepts both the Coalition and Common Applications -- is there a preference 	I do not know if there is a preference between them 	A2NI2HSU84PHJW
When can I expect my refund 	I do not know when you can expect your refund 	A1YKWG46AWMPUX	
My telephone product is suddenly acting strange or stopped working altogether . What can I do 	I do not know what you can do about your telephone product suddenly acting strange or stopped working 	A1X3SF2W1QQBY1
Are commercial photography and videography allowed 	I do not know if commercial photography and videography allowed 	A3RD486RQUI2XV
Do you race the cars	I do not know if you race the cars	APF1EAZT104LQ
What if my county is n't declared 	I am not able to tell you what will happen if your county is n't declared 	A1A0PNOBFTTHGP
What happens if my child misses a class 	I do not know what happens if your child misses a class 	A2RHBR7XZGUI1C
How will the project work to limit construction noise 	I do not know how the project will work to limit construction noise 	A3CL6GEDFNQGQY
Is photography permitted in the Museum 	I do not know if photography is permitted in the Museum	ATQD23E8ESFSI
Will I learn the latest steps 	I do not know the latest steps	APF1EAZT104LQ
Are memberships tax-deductible 	I do not know if memberships tax-deductible 	A3RD486RQUI2XV
Can you check on the status of my rebate 	I am not able to check on the status of your rebate 	A325WS381BHOHH	
I 've downloaded an ISO file , now what 	I do not know what you should do now 	A13GUTDMGGZZDL
Is an address card provided with the residence permit 	I do not know if an address card is provided with the residence permit 	A2D0IIX70FDQIW
I would like to change the due date on my card . Is that possible 	I do not know if it is possible to change the due date on your card 	AE9M4Z1NCYSDM	
Can you provide me with a list of benefits my insurance policy gives me 	I am not able to provide you with a list of benefits your insurance policy gives you	A23CTGXNDDW5LC
Can I leave the ARU during my hospital stay 	I do not know if you can leave the ARU during your hospital stay 	AZLZA0Q87TJZO
What happens when my application is reviewed 	I do not know what happens when your application is reviewed 	AT7ADQKXKXEWY
Last year , my parents and I both took out student loans for me . We both received Form 1098-E for our separate loans . I was n't their dependent last year . Can we both claim student loan interest on our tax returns 	I do not know if you can both claim student loan interest on your tax returns 	ARKAJ6PL85CME
After performing a sequence of calculations in S-V.P.A.M. Series , when I attempt to store the answer in memory , the value changes to something else altogether 	I do not know why after performing a sequence of calculations in S-V.P.A.M. Series , when you attempt to store the answer in memory , the value changes to something else altogether 	A1J0GU26323WVA
Can I fly directly to Kalamazoo from Chicago 	I do not know if you can fly directly to Kalamazoo from Chicago 	AD9O852KPYLHY	
Will you be carrying Michael Kors ' latest collection at your store 	I do not know if we will be carrying Michael Kors ' latest collection at our store	A23CTGXNDDW5LC	
Can I make a donation to support the Prado Museum without being a member 	I do not know if you can make a donation to support the Prado Museum without being a member 	A1J0GU26323WVA
Can I take lessons by myself 	I do not know if you can take lessons by yourself 	A1A0PNOBFTTHGP
What payment methods do you offer	I do not know the payment methods we offer 	A2K9PB0U45O0MU
What is your policy regarding the donation of complimentary tickets 	I do not know our policy regarding the donation of complimentary tickets 	A16NITTBMCSN0V
If I promote to a new job , how is my raise determined 	I do not know how your raise is determined 	A7SXWHGK8B40R
What is Dumping 	I do not know about dumping 	ABN6GDFW4N8AK
If there are two equally qualified candidates and I have an Affirmative Action goal and one of the applicants meets the goal , do I have to select that person 	I do not know if you have to select the applicant who meets the goal if you have an Affirmative Action goal and two equally qualified candidates 	A5VBIZ2KIQ1R8
Do you sell custom frames 	I do not know if we sell custom frames 	A3SSJNH5SIZUPG	
Where do I designate flight search preferences 	I do not know where you can designate flight search preferences 	A13GUTDMGGZZDL
Are representatives available twenty four hours a day 	I do not know if representatives are available twenty-four hours a day 	A39MLQY9HOG1S6
Do you accept nontraditional currency , like Bitcoin 	I do not know if we accept nontraditional currency , like Bitcoin 	ASFR82SJYMGNU
How often do the sacs need to be emptied 	I do not know if the sacs need to be emptied 	A2UBEPT605E8T2
I want to know when I can expect my insurance to go into effect 	I do not know when you can expect your insurance to go into effect 	AE9M4Z1NCYSDM	
I got a broken product and need help with an exchange 	I am not able to help with an exchange 	A185P3B2MC2K83
What dining options are available at the Museum	I do not know what dining options are available at the museum 	A1Z9FHDWNXG2SK
I 'd like to check the status of my store pickup purchase 	I am not able to check the status of your store pickup purchase 	A3GNQDFPZALU92	
Can my children visit the museum with a family caregiver 	I do not know if your children can visit the museum with a family caregiver 	A2I4VNAS21FXCE
Can you recommend a place to stay 	I am not able to recommend a place to stay 	A2NI2HSU84PHJW
Is the pathway easily accessible for least fit people and Seniors	I do not know if the pathway is easily accessible for least fit people and seniors 	A2K9PB0U45O0MU
What is the Dorint Card 	I do not know what the Dorint Card is	A23CTGXNDDW5LC
I got married , will this change my policy rate 	I do not know if being married will change your policy rate 	A9LX66EQWDRQ5	
Will I be assessed during the course 	I do not know if you will be assessed during the course 	A2D0IIX70FDQIW
Paper passes vs electronic passes , what is the difference 	I do not know what the difference in Paper passes vs electronic passes is 	A3RD486RQUI2XV
On what form do I deduct the standard mileage rate for my business travel , and do I also need to figure depreciation of the vehicle 	I do not know what form is needed to deduct the standard mileage rate for business travel , nor do I know if you need to figure the depreciation of the vehicle 	A1YUEWAWRZ590A
Where can I download a foot size template for ordering shoes from your website 	I do not know where you can download a foot size template for ordering shoes from our website 	AE9M4Z1NCYSDM	
Hi , are you able to tell me more about why my order is currently delayed 	I am not able to tell you more about why your order is currently delayed 	ASFR82SJYMGNU
Are dependents covered under the Health Insurance Portability and Accountability Act -LRB- HIPAA -RRB- 	I do not know if dependents are covered under the Health Insurance Portability and Accountability Act -LRB- HIPPA -RRB- 	A7SXWHGK8B40R
What number can I call to talk to a real customer service rep	I do not know what number you can call to talk to a customer service rep	A1HQRT1UG6ERGL
What days and Times do I need to be available to volunteer	I do not know what days and times you need to be available to volunteer 	AT7ADQKXKXEWY
Are you open tomorrow evening 	I do not know if we are open tomorrow evening 	AE9M4Z1NCYSDM	
Do I have to adhere to FMLA if I am with a PEO 	I do not know you have to adhere to FMLA if you are with a PEO	A16184N1RO5OJV
When is the best time to find good deals 	I do not know the best time to find good deals 	AE9M4Z1NCYSDM	
When should I expect to receive my package 	I do not know when you should expect to receive your package 	A31A4YKVSOYRVS	
Are off leash dog walks or exercise activities available 	I do not know if off leash dog walks or exercise activities are available 	A1A0PNOBFTTHGP
What do you guys charge for shipping 	I do not know what we charge for shipping 	A31A4YKVSOYRVS	
Where is the closest parking lot to the Museum 	I do not know the closest parking lot to the museum 	A2NI2HSU84PHJW
What facilities and services are available to me 	I do not know what facilities and services are available to you 	A3I9FTHSULHPYS
Who ships your boat kits 	I do not know who ships the boat kits 	AD9O852KPYLHY	
Can I have a small fry and a large coke 	I am not able to give you a small fry and a large coke 	A31A4YKVSOYRVS	
What are some examples of what it looks like to live within one planet in a developed nation 	I do not know what some examples are 	A13GUTDMGGZZDL
Do you have a list of the aircraft on display in the museum 	I do not know if there is a list of the aircraft on display in the museum 	A2NI2HSU84PHJW
Can you please cancel my subscription , I can not afford it at this time 	I am not able to cancel your subscription 	A9LX66EQWDRQ5	
Is it possible to get my package shipped to somewhere other than my home address 	I do not know if you can get your package shipped to somewhere other than your home address 	AD9O852KPYLHY	
Is help available to researchers 	I do not know if help is available to researchers 	A235UQRA8GE18X
My account is showing charges which I did not make	I do not know about charges you did not make showing to your account 	A1JBSFXMMRGSQD
Can you adjust some things made on my order 	I am not able to adjust some things made on your oder 	ASFR82SJYMGNU
Are Zoo School students outside a lot 	I do not know if Zoo School students are outside a lot 	AZLZA0Q87TJZO
How long after I place an order online can I pick it up in store 	I am not able to tell you how long it would be before you could pick an order up in a store after ordering it online 	A3RD486RQUI2XV
I submitted a request for the deletion of my domain , and the page is still visible , why 	I am not able to tell you why the page is still visible after submitting a request for the deletion of your domain 	AU3WB2DD4QJ4B
Can Family Members Or Friends Use My Membership Card 	I do not know if family members or friends can use your membership card 	A2NI2HSU84PHJW
How do I do research at the Archives 	I do not know how to do research at the Archives 	A2115OWJ0CKOB3
What time can I contact your customer service 	I do not know what time you can contact our customer service 	A2RHBR7XZGUI1C
Ok , so how do I join 	I do not know how you can join 	APC99TPURUHR8
Why does your company ask for my personal information 	I do not know why our company asks for your personal information 	A325WS381BHOHH	
Should I get a room at the hotel 	I do not know if you should get a room at the hotel 	AZLZA0Q87TJZO
Do you close at 10 PM 	I do not know if we close at 10 PM 	A3SSJNH5SIZUPG	
Is the zip line course safe for children 	I do not know if the zip line course is safe for children 	A1YKWG46AWMPUX	
Are there any Granny Smith apples available	I do not know any Granny Smith apples are available 	A31A4YKVSOYRVS	
What are ' Top Selling Items ' 	I do not know what the Top Selling Items are 	A5VBIZ2KIQ1R8
Can you tell my why my shipment was delayed 	I am not able to tell you why your shipment was delayed 	A260AFDCSXBQOH
What happens if I took off the tags of my product and I need to exchange it 	I do not know what happens if you took the tags off your product and you need to exchange it	A23CTGXNDDW5LC
How long do i have before I can edit/cancel my order 	I do not know how long you have before you can edit/cancel your order 	AE9M4Z1NCYSDM	
How do I cancel or change a reservation 	I do not know how to cancel or change a reservation	A2K9PB0U45O0MU
Is the interest amount that we paid to the IRS deductible 	I do not know if the interest amount that we paid to the IRS deductible	A3NHJPE6326P9V
How do I open an account 	I do not know how to open an account 	A113OGTB578EF6	
do you have a price matching policy	I do not know if we have a price matching policy	AJ7MWBQFNH3E4
I 'm not sure my order went through , can you check for me 	I am not able to check for you 	A260AFDCSXBQOH
My company has a matching gift program . Is the Honolulu Museum of Art eligible to receive matching gifts 	I do not know if Honolulu Museum of Art is eligible to receive matching gifts 	A1IPD4WBT3A5GG
Are there any insurance options available for this kind of vehicle 	I do not know if there any insurance options available 	A27CB6JIC5MZFR
How do I check the status of an order online 	I do not know how you check the status of an order online 	A3RD486RQUI2XV
What age range is the Miffy Museum suitable for 	I do not know what age range the Miffy Museum is suitable for	A23CTGXNDDW5LC
I purchased tickets a while ago , but now I ca n't find my confirmation email/tickets . What do I do 	I do not know what you do	A23CTGXNDDW5LC
Do your classes meet academic standards 	I do not know if our classes meet academic standards 	A7SXWHGK8B40R
How much support comes with the software 	I do not know how much support comes with the software 	APC99TPURUHR8
When will I see the design for my space 	I do not know when you will see the design for your space 	A3CL6GEDFNQGQY
Is the mortgage interest and real property tax I pay on a second residence deductible 	I do not know if it is deductible 	A2NI2HSU84PHJW
I would like to add some new services to my account 	I am not able to add some new services to your account	A23CTGXNDDW5LC	
I 'm interested in seeing a Las Vegas show when I visit , what 's playing 	I am not able to tell you what is playing when you visit Las Vegas 	A3RD486RQUI2XV
I would like to donate my body to the Museum . How do I do this 	I do not know how you would donate your body to the Museum 	A16VTK6KZ1U69H
Can you check to see why my gift card balance has n't applied to my account 	I am not able to check your gift card balance 	AG3JT2OA3W9Z1	
With whom can I talk to learn about donating or pricing art of which I am in possession or exhibiting personal work	I do not know WITH who you CAN TALK TO LEARN ABOUT DONATING OR PRICING ART OF WHICH you are IN POSSESSION OR EXHIBITING PERSONAL WORK	ATQD23E8ESFSI
Do you have my order history 	I do not know if we have your order history 	A31A4YKVSOYRVS	
Why does Wag Hotels require the Bordetella vaccination to be administered 7 days prior to arrival to check-in if it has expired or has never been administered 	I do not know why Wag Hotels requires the Bordetella vaccination to be administered 7 days prior to arrival to check-in if it has expired or has never been administrated 	APC99TPURUHR8
My order still has n't arrived yet , what can I do 	I am not able to check on your order 	A3GMY4693OWIRX
I missed the date on my ticket . Can I use my tickets for another day 	I do not know if you can use your ticket for another day if you missed the date on it 	A1JBSFXMMRGSQD
Can I add an additional item to my order without cancelling it 	I do not know if you can add an additional item to your order without cancelling it	A23CTGXNDDW5LC	
What laws protect an employee from harassment 	I do not know what laws protect an employee from harassment 	A1S8DYWNS59XWB
Is Tracking Available	I do not know if tracking is available 	A3SS1F4F3JE7CU
How long will it take to get from the entrance to the Learning Platform 	I do not know how long it will take to get from the entrance to the Learning Platform 	A1JBSFXMMRGSQD
Will you ship to countries overseas 	I am not able to ship to countries overseas 	AI4AO0O0WIJF7
How does guest admission work 	I do not know how guest admission works 	A2K9PB0U45O0MU
How do I book an education program 	I do not know how to book an education program 	A9LX66EQWDRQ5
Why not just run the fans when the building is occupied	I do not know why not just run the fans when the building is occupied 	A2K9PB0U45O0MU
There 's a product missing on my receipt 	I do not know if a product is missing on your receipt 	A1YKWG46AWMPUX	
Is the museum handicap accessible 	I do not know if the museum is handicap accessible 	A2HKTM4Z8652
Does my company provide a discount on this service 	I do not know if your company provides a discount on this service 	A325WS381BHOHH	
Can a minor attend the event if accompanied by a parent or guardian 	I do not know if a minor can attend the event if accompanied by a parent or guardian 	AZLZA0Q87TJZO
Do you offer a shipping discount if I buy multiple items 	I do not know if we offer a shipping discount if you buy multiple items	A23CTGXNDDW5LC	
When do you guys think you will have this item in store again 	I do not know when we will have this item in the store again 	A1J0GU26323WVA	
When do you expect to have the item back in stock 	I do not know when we expect to have item back in stock 	A9LX66EQWDRQ5	
Where can I find the captions for the images 	I do not know where you can find captions for the images 	A1JBSFXMMRGSQD
What happens after I submit my resume 	I do not know what happens after you submit your resume 	A1JBSFXMMRGSQD
I missed a class in-between , Am I still able to take the next/following class 	I do not know if you 're able to take the next class 	A2K2MFQMN31DZ
I want to know that if I close my account today , what will happen to the payments I am due in the future 	I do not know what will happen to your payments in the future if you close your account today 	AE9M4Z1NCYSDM	
Do you offer different finishes for this litter box 	I do not know if we offer different finishes for this litter box 	A3VV5FFG6GXE1S	
What if I make a mistake 	I do not know what you can do if you make a mistake 	A2VIN0EE9BGPSH
Approximately how long does it take to look around TNM 	I do not know how long it will take to look around TNM 	A3I9FTHSULHPYS
Will disconnecting from the Internet during download break the movie 	I do not know if disconnecting from the Internet during download breaks the movie 	A7SXWHGK8B40R
Is access to the GRAMMY Gallery included in price 	I do not know if access to the GRAMMY Gallery is included 	A2K9PB0U45O0MU
Can I purchase additional insurance once the warranty period ends 	I do not know if you can purchase additional insurance once the warranty period ends 	A31A4YKVSOYRVS	
Will I have enough time with a 9:30 ticket	I do not know if you will have enough time with a 9:30 ticket 	A15UV2T9GKXSI4
Are there fees charged in addition to the listed package prices	I do not know if there are fees charged in addition to the listed package prices 	A2NI2HSU84PHJW
What is the inseam on the slacks 	I do not know what the insteam is on the slacks 	A3VV5FFG6GXE1S	
How will the personal information submitted at the time of visa application be handled 	I do not know how your personal information will be handled 	A2L0QFWMJU0AXB
Can I get an additional bed added to my room	I do not know if you can get an addition bed added to your room 	A13GUTDMGGZZDL
How much would shipping be to my address 	I do not know how much shipping would be to your address 	A2YQAE441JMA7V	
My prepaid Gift Card is not working	I do not know why your prepaid gift card is not working 	AZLZA0Q87TJZO
How many people are attacked each year by sharks 	I do not know how many people are attacked by sharks each year	A3NZLRU95OULXB
My baby is hungry , is there a space where I can breast-feed privately 	I do not know if there is a space where you can breast-feed privately 	A2HKTM4Z8652
Will there be ATMs available at the event 	I do not know if there will be ATMs available at the event 	A13GUTDMGGZZDL
Is Panama safe 	I do not know if Panama is safe 	AZLZA0Q87TJZO
Is there a website that can show me everything in box office history 	I do not know if there is a website that can show your box office history 	A2NI2HSU84PHJW
Is St Katherine 's a Church 	I do not know if St. Katherine 's is a church 	A2NI2HSU84PHJW
What holidays are you closed 	I do not know what holidays we are closed 	A2YQAE441JMA7V	
Where can I get more information on the Intel TBB open-source offering 	I do not know where you can get more information on the Intel TBB open-source offering 	A3NZLRU95OULXB
Can I schedule some viewings this weekend 	I do not know if we can schedule some viewings this weekend 	A3VV5FFG6GXE1S	
I 'd like an update on this invoice that I have 	I am not able to provide you with an update on the invoice that you have	AYJGJAIY0EXW
How do I submit my Essay for the Coalition Application 	I do not know how you can submit your essay for the coalition application 	A7SXWHGK8B40R
Why am I occasionally seeing an XFINITY WiFi notifications 	I do not know why you are occasionally seeing an XFINITY WiFi notifications	A23CTGXNDDW5LC
I 'd like to calculate the tax before I pull the trigger 	I am not able to calculate the tax 	A3O81LHBBI8NPK
What happens during Morning Care 	I do not know what happens during Morning Care 	A2K2MFQMN31DZ
What do I do if I lost my print-at-home tickets 	I do not know what to do if you lost your print-at-home tickets 	A1S0R9UMW0FWAZ
Can I buy a car online 	I do not know if you can buy a car online 	A2VIN0EE9BGPSH
Do you send free gifts with the fist item purcheses 	I do not know if we send free gifts with the fist item purcheses	A23CTGXNDDW5LC	
Do you offer shipping insurance on your items 	I do not know if we offer shipping insurance on our items 	A2G9G9KF1S6X75	
When is the AACA Museum open 	I do not know when the AACA Museum is open 	A2K9PB0U45O0MU
Does my child need a ticket 	I do not know if your child needs a ticket 	A3RD486RQUI2XV
Are there benches in the galleries or other places to rest during my visit 	I do not know if there are benches in the galleries or places to rest during your visit 	A7SXWHGK8B40R
Have you ever tried this product 	I am not able to tell you if I have ever tried this product 	AE9M4Z1NCYSDM	
What member events are offered 	I do not know what member events are offered 	A1J0GU26323WVA
Is there a way to purchase tickets in advance	I do not know if you are able to purchase tickets in advance 	A3RD486RQUI2XV
In lieu of gifts , can we collect donations to Adopt-An-Animal through the Valley Zoo Development Society or to buy an elephant or seal painting 	I do not know if you can collect donations to Adopt-An-Animal through the Valley Zoo Development Society 	A2NI2HSU84PHJW
When can I expect the new product to come in 	I do not know when you can expect the new product to come in 	A2PKDWREQV1JTR
We have offices in other cities , can we get those offices involved as well 	I do not know if we can get those other offices involved as well 	A36EXF1KC09IER
Do you have a dumping waste station for RV 's in the area 	I do not know if we have a dumping waste station for RV 's in the area 	A3G2FBKYCRD5Q8
Do you offer international shipping options 	I do not know if we offer international shipping 	AD9O852KPYLHY	
I would like to dispute a charge for a purchase that I did n't authorize 	I am not able to help you dispute a charge for a purchase you did n't authorize 	A3SSJNH5SIZUPG	
Does the Museum have wheelchair facilities 	I do not know if the Museum has wheelchair facilities 	A20WRVVT7WQFT7
Are Facebook posts , tweets and use of other social media protected by the National Labor Relations Act -LRB- NLRA -RRB- 	I do not know if Facebook posts tweets and use of other social media protected by the National Labor Relations Act -LRB- NLRA -RRB- 	A1IMICF9ISISZN
How is a side pot is shared 	I do not know how a side pot is shared 	A9LX66EQWDRQ5
How often is the employment job line updated 	I do not know when the employment job line gets updated 	AF1VPADWTM40W
Why is there an over draft showing on my account 	I do not know why there is an over draft showing on your account	A23CTGXNDDW5LC
What information must be included in the health care exchange notice that an employer is required to provide to employees under the Affordable Care Act -LRB- ACA -RRB- 	I do not know what information must be included in the health care exchange notice 	A2VFX3J4B1I22X
How do I get permission to publish an image from the collection 	I do not know how you get permission to publish an image from the collection 	A16VTK6KZ1U69H
Can I add a gift message to an online order 	I do not know I you can add a g ift to your online order 	A19F9CLZ0XWBYR	
What is HIPAA 	I do not know what HIPAA is 	A1JBSFXMMRGSQD
Can you get me a block of tickets in the section right behind the goal 	I am not able to get you a block of tickets in the section right behind the goal	A23CTGXNDDW5LC
Is the courier out yet with my package 	I do not know if the courier is out with your package 	AD9O852KPYLHY	
Is an employer required to use E-Verify 	I do not know if an employer is required to use E-verify 	A116N2LEI6O7HB
I do n't see the Windows 8.1 or Windows 10 edition I 'm looking for . Where else should I check 	I do not know where else you should check	A23CTGXNDDW5LC
Can I have more than one email address 	I do not know if you can have more than one email address 	A1J0GU26323WVA
Can I rent a stroller , wheelchair or electronic vehicle 	I do not know if you can rent a stroller , wheelchair , or electronic vehicle 	A2K9PB0U45O0MU
What is Toyota Rent a Car 	I do not know what Toyota Rent a Car is 	A5VBIZ2KIQ1R8
Does my school or group need to make a reservation to visit the Queens Zoo	I do not know if your school or group need to make a reservation to visit the queens zoo 	A235UQRA8GE18X
Who do I contact to receive a price adjustment 	I do not know who to contact to receive a price adjustment 	ASFR82SJYMGNU
How do I sign up for a membership 	I do not know how you sign up for a membership 	A3U0VQ420HIMQ0
What about a version of that but with a lot more inside jokes and less helpfulness 	I do not know about a version with more inside jokes and less helpfulness 	ARKAJ6PL85CME
I/my child is new to the dance world . What do we need to know 	I do not know what you and your child need to know for dance world 	A2VIKCIM9TZL22
How long will the balloons stay inflated 	I do not know how long the balloons will stay inflated 	A325WS381BHOHH	
What are group classes 	I do not know what group classes are 	A8O98QNRG9SHV
How long can I stay out in the backcountry 	I do not know how long you can stay out in the backcountry 	A2VIKCIM9TZL22
How do I report this Form 1099-DIV I received from my mutual fund 	I do not know how you report this Form 1099-DIV you received form your mutual fund 	AZLZA0Q87TJZO
How is the museum funded 	I do not know how the museum is funded 	A16NITTBMCSN0V
If I purchase a membership that includes more than one adult , do I have to name the other adult -LRB- S -RRB-	I do not know if you have to name the other adult 	A2K2MFQMN31DZ
What is the attachment file size limit or maximum 	I do not know the maximum file size limit for an attachment 	A14M2EERU7E8KD
Do I need a computer	I do not know if you need a computer 	A5VBIZ2KIQ1R8
What is the difference between soft and hard shell crabs 	I do not know the difference between soft and hard shell crabs 	A2UBEPT605E8T2
How do I locate the country of origin on the bottle 	I do not know how to locate the country of origin on the bottle 	A2ZBJWQ9ZZHYYI
Are there fees associated with opening a savings account 	I do not know if there are fees associated with opening a savings account 	A1GAARR4GOOZCO	
What is the legal basis for the issuance or non-issuance of my visa 	I do not know what the legal basis for the issuance or non-issuance is of your visa 	A9LX66EQWDRQ5
What is the University 's Employer Registered Number 	I do not know what the University 's Employer Registered Number is 	A1JBSFXMMRGSQD
Can I print my own postage or do I need to fill out customs forms at the post office 	I do not know if you can print your own postage 	A3RD486RQUI2XV
Do exhibitions ever sell out 	I do not know if exhibitions ever sell out 	APC99TPURUHR8
Are the pants blue	I do not know if the pants are blue	A23CTGXNDDW5LC	
Will y' all report to my credit 	I am not able to report to your credit 	ASFR82SJYMGNU
What kind of coffee grinder should I buy 	I do not know what kind of coffee grinder you should buy 	A7SXWHGK8B40R
can you check the sizes for the blue pants 	I am not able to check the sizes for blue pants	A23CTGXNDDW5LC	
Do you have any one bedroom apartments available in your complex 	I do not know if we have any one bedroom apartments available in our complex 	AE9M4Z1NCYSDM	
Why ca n't I log in 	I do not know why you ca n't log in 	A1J0GU26323WVA
Do you have a rewards program 	I do not know if we have a rewards program 	A31A4YKVSOYRVS	
What is your cancellation or missed class policy	I do not know about the cancellation or missed class policy 	A2NI2HSU84PHJW
If I submitted my order before I used the promo code , can I still have the promo code applied 	I do not know if you can still have the promo code applied 	AD9O852KPYLHY	
Where are your ATMs located 	I do not know where the ATMs are located 	A1AVKKVWWFUGLT
How will I know when my order is ready for pickup	I do not know how you will know when your order is ready for pickup 	A3RD486RQUI2XV
Must an employer keep Fair Labor Standards Act -LRB- FLSA -RRB- records for nonexempt employees 	I do not know if an employer must keep Fair Labor Standards Act -LRB- FLSA -RRB- records for nonexempt employees 	APC99TPURUHR8
Where can I view my coverage for my travel destination 	I do not know where you can view your coverage for your travel destination 	A7SXWHGK8B40R
What are your opening hours 	I do not know the opening hours 	A2K9PB0U45O0MU
Do you offer an extended service plan 	I do not know if we offer an extended service plan 	A9LX66EQWDRQ5	
Why does your current market value differ from what I found on consumer websites 	I do not know why our current market value differs from what was found on consumer websites 	A7SXWHGK8B40R
When is my next payment due , and how much will it be 	I do not know when your next payment is due and how much it will be	A23CTGXNDDW5LC
How can I be sure my on-line application was received 	I do not know how to be sure your on-line application was received 	A2TP3K1THK6XRB
Can we bring in outside food to the museum 	I do not know if you can bring outside food to the museum 	A3B2YRXL26RPVH
Are there scholarships available 	I do not know if scholarships are available 	A2K9PB0U45O0MU
Is there a way to gift a membership to an unknown recipient 	I do not know if there is a way to gift a membership to an unknown recipient 	A13GUTDMGGZZDL
How do I get to the Zoo from the train station 	I do not know how to get to the Zoo from the train station 	A7SXWHGK8B40R
Hi , can you help me because it looks like my credit card was charged two times in the of $ 65.70 for the same order # 3346 	I do not know why your credit card was charged two times in the amount of $ 65.70 	A31A4YKVSOYRVS	
What is the difference between Background Only , Personalized and 7-Letter Personalized 	I do not know the difference between Background Only , Personalized and 7-Letter Personalized 	AT7ADQKXKXEWY
When do classes begin 	I do not know when classes begin 	A2K9PB0U45O0MU
What are some of the smart features of the Form I-9 	I do not know what the smart features are of Form I-9 	A2EJ7U3TZAKROG
Do I have to sign a contract 	I do not know if you have to sign a contract 	AE9M4Z1NCYSDM
What if the weather is bad , can we get a refund or reschedule our bus permit or pavilion fee 	I do not know if you can get a refund or reschedule your bus permit or pavilion fee if the weather is bad 	A8O98QNRG9SHV
I have an email address on my license record , but I have n't received any emails from DPR . Why 	I do not know why you have n't received any emails from DPR if you have an email address on your license record 	AZLZA0Q87TJZO
What 's going on Today	I do not know what 's going on today 	A2NI2HSU84PHJW
Can eligible hospitals participate in both programs 	I do not know if eligible hospitals can participate in both programs 	A2K9PB0U45O0MU
How to read the original and new T for Texas plate designs 	I am not able to read the original and new T for Texas plate designs 	A1IMICF9ISISZN
What are the beds like in the rooms 	I do not know what the beds in the rooms are like 	APC99TPURUHR8
I need an update on my order status	I am not able to give you an update on your order status 	A3SZ3W7V3GUN8Z
How do I cancel my order 	I do not know how you cancel your order 	A3U0VQ420HIMQ0
When I lease cars to individuals , there is often a manufacturer 's rebate offered in connection with the lease . For my customers to qualify for the rebate , I need to disclose personal information from the lease transaction to the manufacturer . If the customer wants the manufacturer 's rebate , do I have to give an opt-out notice to her before sending the information to the manufacturer 	I do not know if you need to give an opt-out notice to her before sending the information to the manufacturer 	A5VBIZ2KIQ1R8
What if a class is closed	I do not know your alternatives if a class is closed 	A13JQTLPWXZD6L
Do you have a music streaming package for businesses 	I do not know if we have a music streaming package for businesses 	A1YKWG46AWMPUX	
How do I apply for 2018 	I do not know how to apply for 2018 	A3U0VQ420HIMQ0
Where are the bears 	I do not know where the bears are 	A8O98QNRG9SHV
My product was delivered to my billing address instead of my shipping address 	I am not able to help you with your product that was delivered to your billing address instead of your shipping address 	A325WS381BHOHH	
Which brands does CDW carry 	I do not know what the specific brands are that CDW carries 	A2O2Q0LVWOWJ1G
What 's new for ZooLights 2017 	I do not know what is new for ZooLights 2017 	A2TP3K1THK6XRB
Paying for the Recital - How come I must pay for my child to be in the Recital 	I do not know why you must pay for your child to be in the Recital 	A7SXWHGK8B40R
I submitted an application several months ago , but never heard anything back . Is there a still a chance that I could volunteer	I do not know if there is a chance you could still volunteer 	A2K9PB0U45O0MU
Could you fit me for a new bra 	I am not able to fit you for a new bra 	A3VV5FFG6GXE1S	
How can I request a ticket donation from the Museum for our fundraiser 	I do not know if you can require a ticket donation from the museum for a fundraiser 	A2NI2HSU84PHJW
What are some new features of the new line of products coming out 	I do not know what some of the new features of the new product line are 	A31A4YKVSOYRVS	
Are there food and drinks provided for Sunday Showcase 	I do not know if there are food and drinks provided for Sunday Showcase 	A3I9FTHSULHPYS
What is the Young@Art Gallery 	I do not know what the Young@Art Gallery is 	A2K9PB0U45O0MU
Can you help my Russian friend visit my country 	I do not know how you can help your Russian friend visit your country 	A2HKTM4Z8652
Are the asphalt seeps restricted to the pits in Hancock Park 	I do not know if the asphalt seeps are restricted to the pits in Hancock Park 	A7SXWHGK8B40R
What does it mean if my order status says processing	I do not know what processing means 	AEXWOFM1LGS6U
Are you able to accommodate my child with medical allergies and/or special needs 	I am not able to accommodate your child 	A298FAWY76NZA9
Do you have to be a certain age to attend 	I do not know if you need to be a certain age to attend	APF1EAZT104LQ
How do I request a copy of my job description 	I do not know how you request a copy of your job description 	A3RD486RQUI2XV
What are the BioPark 's hours 	I do not know the hours 	A2NI2HSU84PHJW
When do hospitals have to meet the Medicaid meaningful use requirements 	I do not know when hospitals have to meet Medicaid meaningful use requirements	APF1EAZT104LQ
May I book a private event at the museum 	I do not know if you can book a private event at the museum 	A2115OWJ0CKOB3
Does Tune Hotels offer refunds 	I do not know if Tune Hotels offers refunds 	A7SXWHGK8B40R
We are interested to work with ArtScience Museum , where can I sign up 	I do not know where you can sign up to work with ArtScience Museum 	A3MFFF0TPDZQZS
Should registered domestic partners report social security benefits as community income for federal tax purposes 	I do not know if registered domestic partners report social security benefits as community income for federal tax purposes 	AC3Z1OB6KTXX
Is there a page on your website where I can see the new merchandise 	I do not know if there is a page on our website where you can see the new merchandise 	A9LX66EQWDRQ5	
How many , and which people are allowed on our membership	I do not know how many , or which people are allowed on your membership 	A9LX66EQWDRQ5
Is there a way I can schedule an order ahead of time to arrive a certain day in the future 	I do not know if you can schedule an order ahead of time to arrive a certain day in the future 	AE9M4Z1NCYSDM	
What ages does your Museum program for 	I do not know what ages the museum is programmed for 	A2NI2HSU84PHJW
Does NARA lend original documents for exhibition use 	I do not know if NARA lends original documents for exhibition use 	A30YFEIPGXNWJL
Does my policy cover teenage drivers 	I do not know if your policy covers teenage drivers 	ARCNENCVA0STW	
Is there an age restriction for the event	I do not know if there is an age restriction for the event 	A3RD486RQUI2XV
How come the monthly fee is going up 	I do not know why the monthly fee is going up 	A260AFDCSXBQOH
Is there a way to lower my monthly bill 	I do not know if there is a way to lower your monthly bill 	A3GNQDFPZALU92	
Can you tell me what the new features of your new phone model are	I am not able to tell you what the new features of our new model are 	A260AFDCSXBQOH
Can I audit a dance course 	I do not know if you can audit a dance course 	A16NITTBMCSN0V
What is the GRE institution code 	I do not know what the GRE institution code is 	A2K2MFQMN31DZ
I do not have health insurance , or have limited coverage , and can not afford to pay my hospital bill . Do you have a program to help me 	I do not know if we have a program to help you 	A13GUTDMGGZZDL
What is the delivery status of my order 	I do not know the delivery status of your order 	AD9O852KPYLHY	
Where can I find primary sources about the transcontinental railroad 	I do not know where you can find primary sources about the transcontinental railroad 	A2NI2HSU84PHJW
What are the dining options at The Field Museum 	I do not know what the dining options are at The Field Museum 	AT7ADQKXKXEWY
How can I find a guide 	I do not know how you can find a guide 	A1JBSFXMMRGSQD
Do you carry Carhartt jeans	I do not know if we carry Carhartt jeans 	A1YKWG46AWMPUX	
How much data can I store 	I do not know how much data you can store 	A2K9PB0U45O0MU
Who can book on united.com 	I do not know who can book on united.com 	A2NI2HSU84PHJW
What package has the most channels 	I do not know what package has the most channels	A23CTGXNDDW5LC	
Please check the status of my most recent order	I am not able to check the status of your most recent order 	A325WS381BHOHH	
Can I purchase Kias for my fleet 	I do not know if you can purchase Kias for your fleet 	A116N2LEI6O7HB
Are there any other sizes available at this time 	I do not know if there are other sizes available 	A1HQRT1UG6ERGL
How do I get a UL parking permit 	I do not know how you get a UL parking permit 	A2UBEPT605E8T2
How can I find out more about the CINEPOLIS REWARDS Program	I do not know how you can find out more about the Cinepolis Rewards Program	AEB42Q2Z31GN
How do the terms on my pre-qualification offer match with what I receive at the dealer 	I do not know how the terms on your pre-qualification offer match with what you 'll receive at the dealer 	APC99TPURUHR8
I would like to use some of your recipes on my website . May I have permission to use your recipes 	I am not able to give you our permission to use our recipes on your website 	A116N2LEI6O7HB
How long can I stay in Guatemala	I do not know how long you can stay 	A13GUTDMGGZZDL
What 's included in a driving record 	I do not know what 's included in a driving record 	A355BVFIOODRH2
What if I want to visit another zoo and I do not have my membership card	I do not know what you should do if you want to visit another zoo and do not have your membership card 	A2HKTM4Z8652
Which vaccines are required for my DOG in order to stay at a Wag Hotels 	I do not know what vaccines are required for your dog in order for it to stay at Wag Hotels 	A5VBIZ2KIQ1R8
How do I import products into the United States 	I do not know how you import products in the United States 	A3LA5P3N3KI8U7
What is expected of essential services employees 	I do not know what is expected of essential services employees 	A1BWNS27NA1JAP
How can I avoid foodborne illness and food poisoning 	I do not know how you can avoid foodborne illness and food poisoning 	A1JBSFXMMRGSQD
Can I get this item gift wrapped 	I do not know if you can get this gift wrapped 	AD9O852KPYLHY	
How many students are in a class 	I do not know how many students are in a class 	A2K9PB0U45O0MU
If it is wet , is there anywhere to eat our packed lunches 	I do not know if there is a place to eat your packed lunches 	A2NI2HSU84PHJW
What is the best way to learn to dance -- group classes or private lessons 	I do not know the best way to learn to dance 	A3LVU39B5A9MNI
My stress level is through the roof . It seems as if no one believes in cooperation any more . Any ideas before I hurt myself 	I am not able to give you any ideas	A1CMT9MVUO52VP
Do you offer special assistance for customers with disabilities 	I do not know if we offer special assistance for customers with disabilities 	A9LX66EQWDRQ5
Can I pay with cash 	I do not know if you can pay with cash 	A2EAJXBORHT44T	
Why do you use video interviews 	I do not know why we use video interviews 	A2NI2HSU84PHJW
Where can I view my Choice Privileges statements 	I do not know where you can view your Choice Privileges statements 	A2VIKCIM9TZL22
Where do I go to change my beneficiaries 	I do not know where you go to change your beneficiaries 	A3G2FBKYCRD5Q8
What are my options , now that my car lease is almost up 	I do not know what your options are , now that yor car lease is almost up	A23CTGXNDDW5LC	
I forgot my password and email but I know I had an account with you guys , can you help me figure it out 	I am not able to help you figure it out if you forgot your password and email but you know you had an account with us 	A3GNQDFPZALU92	
Is there a ist of store locations that carry this specific product 	I do not know if there is a list of store locations that carry this specific product 	A9LX66EQWDRQ5	
What kind of prepaid plans does your cell phone company offer 	I do not know what kind of prepaid plans our company offers 	AD9O852KPYLHY	
What is ' Cashless ' Payment 	I do not know what ' Cashless ' Payment is 	A30YFEIPGXNWJL
Where can I buy an owners or service manual 	I do not know where you can buy an owners or service manual 	A2VIKCIM9TZL22
How does my organisation benefit from the UN Job List 	I do not know how your organisation benefits from the UN Job List 	A2HKTM4Z8652
Does picture book art have any special requirements 	I do not know if the picture book art has any special requirements 	A2HKTM4Z8652
Once my claim is approved , are there any restrictions around my reservation 	I do not know if there are any restrictions 	A1DWQO9X2ZQ35G
Does Mandalay Bay offer travel agent rates	I do not know if Mandalay Bay offers travel agent rates 	A3R71HP45TBQ7O
What do I do if I lost my membership card 	I do not know what you should do if you lost your membership card 	A9LX66EQWDRQ5
How long is my passport valid 	I do not know how long your passport is valid 	A5VBIZ2KIQ1R8
How do I book a session -LRB- taught or self-guided -RRB-	I do not know how you can book a session 	A3CL6GEDFNQGQY
Does Hospital IQ do change management 	I am not able to tell you if Hospital IQ does change management 	A1JBSFXMMRGSQD
I need to change the answers to my security questions on my account , please 	I am not able to change the answers to your security questions on your account 	A8F4B0854KTXO	
Can I have my package left on my porch if I wo n't be home when it arrives 	I do not know if you can have your package left on the porch if you wo n't be home when it arrives 	A325WS381BHOHH	
What 's new about the Product Returns Policy 	I do not know what is new about the Product Returns Policy 	A2VIKCIM9TZL22
What are the office hours 	I do not know the hours 	A1DWQO9X2ZQ35G
Do you have a coffee machine for customers here 	I do not know if we have a coffee machine for customers here 	A2IXBTOWQRCLPZ	
What does your sign mean ' You May Be In Pictures ' at the Front Desk 	I do not know what our sign means 	A3B2YRXL26RPVH
What if my income exceeds the $ 130,000 maximum , can I still apply 	I do not know if you can still apply if your income exceeds the $ 130,000 maximum 	A1JBSFXMMRGSQD
Why ca n't I download and use the new My Verizon app 	I do not know why you ca n't download and use the new My Verizon app 	A3G2FBKYCRD5Q8
Is my Binghamton Zoo membership good at other zoos 	I do not know if your Binghamton Zoo membership is good at other zoos 	A2TP3K1THK6XRB
Who Do I contact to get donations for my organization	I do not know who to contact to get donations for your organization 	A5VBIZ2KIQ1R8
Could you please let me know if i will be compensated for the minor damages to my ordered product 	I am not able to tell you if you will be compensated for the minor damages to your ordered product	AYJGJAIY0EXW
Where do I find your app for Android 	I do not know where you find your app for Android 	A1GAARR4GOOZCO	
What is dessert like in Guatemala	I do not know what dessert is like in Guatemala 	APC99TPURUHR8
What is Jack Horner 's Relationship to the Museum of the Rockies 	I do not know what Jack Horner 's Relationship is to the Museum of the Rockies 	AZLZA0Q87TJZO
Where is the best spot for a beginner to dance 	I do not know the best spot for a beginner to dance 	A2L0QFWMJU0AXB
I want to buy a gift Membership , do you have gift certificates 	I do not know if we do 	A1DWQO9X2ZQ35G
What about buy one , get one free or items sold for a reduced price 	I do not know about buy one , get one free or items sold for a reduced price 	A7SXWHGK8B40R
Do I need to be a member of 92Y to take a dance class 	I do not know if you need to be a member of 92Y to take a dance class 	A3RD486RQUI2XV
Can I pay for it over the phone 	I do not know if you can pay for it over the phone	A23CTGXNDDW5LC
I have a busy schedule , do I have to register for classes 	I do not know if you have to register for classes 	A3LA5P3N3KI8U7
Can I pay with PayPal on an order 	I do not know if you can pay for an order with PayPal 	A9LX66EQWDRQ5	
Can I bring my own food 	I do not know if you can bring your own food 	A3RD486RQUI2XV
Can I order this item , even though it 's out of stock 	I do not know if you can order this item even though it 's out of stock 	AE9M4Z1NCYSDM	
What state standards are covered in your museum 	I do not know what state standards are covered in our museum 	A3U0VQ420HIMQ0
What new products are available 	I do not know what new products are available 	A9LX66EQWDRQ5	
When can I expect to see the charge placed on my card 	I do not know when you should expect to see the charge	APF1EAZT104LQ
Does store credit ever expire	I do not know if store credit ever expire 	A1QX1RYLCFXZJ9
How do I contact ClinicalTrials.gov if I have a question about my study record 	I do not know how to contact ClinicalTrials.gov for your question	APF1EAZT104LQ
Do you have wheel chair accessible rooms 	I do not know if we have wheel chair accessible rooms 	A7SXWHGK8B40R
Can I use this with multiple students within my home 	I am not able to tell you if this can be used with multiple students within your home 	A1JBSFXMMRGSQD
I have a ticket without an entry date and time . Will you accept it	I do not know if we will accept a ticket without any entry date and time 	A2HKTM4Z8652
How are merit increases processed when there are temporary overrides or other unusual situations 	I do not know how merit increases are processed when there are temporary overrides or other unusual situations 	A1JBSFXMMRGSQD
How will I be prepared to go home 	I do not know how you 'll be prepared to go home 	APC99TPURUHR8
What will be my monthly payment 	I do not know what your monthly payment will be	A23CTGXNDDW5LC
On what types of devices can the ZOOZIL EREADING APP be used	I do not know what type of devices the Zoozil EReading app can be used on 	A1JBSFXMMRGSQD
What if I lose my ZooFriends membership card 	I do not know what happens if you lose your membership card 	A1XNCA1SVTT15B
Do I pay now or when I receive my order 	I do not know if you pay now or when you receive your order 	A31A4YKVSOYRVS	
Do I have to respond to the jury summons 	I do not know if you have to respond to the jury summons 	A2K9PB0U45O0MU
How much will my school group pay 	I do not know who much your school group will pay 	A2EJ7U3TZAKROG
I 'm going to be driving a lot . Where can I find cheap gas 	I do not know where you can find cheap gas	A16184N1RO5OJV
Can I take photos or videos 	I do not know if you can take photos or videos 	A2UBEPT605E8T2
Can I get a confirmation number 	I am not able to give you a confirmation number 	AD9O852KPYLHY	
How can I view My CDW Advantage price while I shop 	I do not know how you could view your My CDW Advantage price while you shop 	A2VIKCIM9TZL22
Can I bring my pet with me on my visit	I do not know if you can bring your pet with you on your visit 	A2UBEPT605E8T2
Where can I get Intel TBB 	I do not know where you can get Intel TBB 	A3G2FBKYCRD5Q8
Who can book a car rental on united.com 	I do not know who can book a car rental on united.com	A7SXWHGK8B40R
Next months charge needs to be charged to the Visa payment on file instead of the current payment method selected 	I am not able to to charge the current payment method to the visa payment on file 	AJNQ2PBD07FKE
Can I exchange my ticket due to wet weather 	I do not know if you can exchange your ticket due to wet weather	A23CTGXNDDW5LC
Looking for appraisal or conservation referrals 	I do not know what you should do if you 're looking for appraisal of conservation referrals 	A13GUTDMGGZZDL
How do I go about returning an order 	I am not able to return an order 	A185P3B2MC2K83
What service do I use to ship my package 	I do not know what service to use to ship your package 	A2UBEPT605E8T2
Can I remain a Classified Staff employee 	I do not know if you can remain a Classified Staff employee 	A1J0GU26323WVA
What should I bring with me to the courthouse 	I do not know What you should bring with you to the courthouse	ATQD23E8ESFSI
Are the Vatican Museums part of the network of museums that can be visited with the Roma Pass 72 Hours and/or Roma Pass 48 Hours 	I do not know if the Vatican Museums are a part of the Roma Pass 72 Hours and/or the Roma Pass 48 Hours 	A2VFX3J4B1I22X
If a California employee requests to bring an assistive animal to work as a reasonable accommodation , what should the employer do 	I do not know what the employer should do if a California employee requests to bring an assistive animal to work as a reasonable accomodation 	A2TP3K1THK6XRB
Do you offer rain checks for items that have sold out on the site 	I do not know if we offer rain checks or items that have sold out on the site 	ASFR82SJYMGNU
How does Beyond Unlimited work when I 'm in Mexico and/or Canada 	I do not know how Beyond Unlimited works in Mexico and/or Canada 	A2VFX3J4B1I22X
Is the boat handicap accessible 	I do not know if the boat is handicap accessible 	A3GNQDFPZALU92	
What 's this about data stale 	I do not know what data stale is about 	AT7ADQKXKXEWY
I think I got a computer virus while on your website 	I do not know if you got a computer virus while on our website 	A31A4YKVSOYRVS	
I would like someone to explain the specs of the products as I am totally new to this 	I am not able to explain the specs of the products 	A3FIJGXCWIHHQ5	
What requirements must be met for moving expenses to be excluded from an employee 's taxable income 	I do not know the requirements that must be met for moving expenses to be excluded from an employee 's taxable income 	A8O98QNRG9SHV
Do I have to inform you if in my group there are children under 6 years of age 	I do not know if you have to inform us if in your group there are children under 6 years of age 	A3I9FTHSULHPYS
How do I pay for museum admission 	I do not know how you pay for museum admission 	A2HKTM4Z8652
I need to replace my item . Can you send me a shipping label so that I may do that 	I am not able to send you a shipping label 	A1CQPRZUT6BW44
Why have I been billed for a warranty replacement part 	I do not know why you have been billed for a warranty replacement part 	A2VIKCIM9TZL22
Could you please help me track my order that was supposed to arrive two days ago 	I am not able to help you track your order that was supposed to arrive 	A31A4YKVSOYRVS	
Can I leave my bags/belongings in a secure place at the zoo 	I do not know if there is a secure place to leave your bags/belongings at the zoo 	A2VIKCIM9TZL22
Can I get a price quoted on a new Kia via the Internet 	I do not know if you can get a price quoted on a new Kia via the Internet 	A2VIKCIM9TZL22
What does my camper need to wear each day 	I do not know what your camper needs to wear each day 	A3UJE4WA5XADZS
What does the volunteer membership fee cover	I do not know what the Volunteer Membership fee covers 	A2K9PB0U45O0MU
Where should we keep employee records 	I do not know where we should keep employee records 	A3NZLRU95OULXB
Do you have a store 	I do not know if we have a store 	A1WRD2K9USCOAV
Does Beiersdorf use palm oil or palm kernel oil 	I do not know if Beiserdorf uses palm oil or palm kernal oil 	A2MISBKRBT4AUA
My parcel is n't here . Can you assist 	I am not able to assist you with your parcel 	A31A4YKVSOYRVS	
How long does My CDW Advantage discount last 	I do not know how long your CDW Advantage discount lasts 	A3U0VQ420HIMQ0
Can you help me find a suitable carseat 	I am not able to help you find a suitable carseat 	A9LX66EQWDRQ5	
Do all of the cars run	I do not know if all the cars run	APF1EAZT104LQ
Will I be able to download files from the Internet to att.net-enabled phones 	I do not know if you will be able to download files from the internet to att.net-enabled phones 	A2LQ9NP944M61Z
Can I leave the Museum and come back the same day 	I do not know if you can leave the Museum and come back the same day 	A16VTK6KZ1U69H
I am a 42 year old female weighing 200 pounds and I am 5 ' 5 ' . Can you provide a diet that will help me lose weight 	I am not able to provide a diet for a 42 year old female weighing 200 pounds that is 5 ' 5 ' 	A2LQ9NP944M61Z
Can I visit the Museum Store Without Paying Admission	I do not know if you can visit the museum store without paying admission 	AZLZA0Q87TJZO
Do you have lockers or coat check 	I do not know if we have lockers or coat check 	A26XN1TM6CV01T
Could I replace a broken item 	I do not know if you can replace a broken item 	A8F4B0854KTXO	
How can I become a member of the Noodles & Company team 	I do not know how you can become a member of the team 	A1F46RJTOXQM4J
will you please tell is there any offers for products 	I do not know if there are any offers for products 	A31A4YKVSOYRVS	
What are the accepted payment methods for the application fee 	I do not know what the accepted payments methods are 	A13GUTDMGGZZDL
Where can I get a list of museums around the world or in a specific country 	I do not know where you could get a list of museums around the world or for a specific country 	A2VIKCIM9TZL22
When do items typically ship after being bought 	I am not able to tell you when the item typically ships after being bought 	A3RD486RQUI2XV
What 's the latest I can return an item 	I do not know what the latest you can return an item is 	A31A4YKVSOYRVS	
Can you help me find an outfit for a party tonight 	I am not able to help you find an outfit 	A31A4YKVSOYRVS	
Do you have any special offers going on right now 	I do not know if there are any special offers going on right now 	AD9O852KPYLHY	
I forgot my answer to the challenge question , how do I access my account 	I do not know how you can access your account 	A2NI2HSU84PHJW
What type of individual is the program seeking to find 	I do not know what type of individual the program is seeking to find 	AZLZA0Q87TJZO
What are my options if my device is lost , stolen or damaged 	I do not know what your options are if your device is lost , stolen or damaged 	A3U0VQ420HIMQ0
I accidentally ordered the wrong chair , how do I cancel my order 	I do not know how to cancel it 	A1DWQO9X2ZQ35G
I keep getting a message to upgrade my modem ; do I have to do that 	I do not know if you have to upgrade your modem 	A9LX66EQWDRQ5	
I ca n't find a space to add my husband 's name , can you help 	I am not able to help	A23CTGXNDDW5LC	
As a monthly paid employee can I ener time retroactively 	I do not know if you can enter time retroactively as a monthly paid employee 	A1J0GU26323WVA
I have a customer service issue 	I am not able to assist you with your customer service issue 	A2D0IIX70FDQIW
Is distance learning available at the graduate level 	I do not know if distance learning is available at the graduate level 	A2TP3K1THK6XRB
Will ZooLights close for inclement weather 	I do not know if ZooLights will close for inclement weather 	AT7ADQKXKXEWY
What do I do if I was shipped the wrong item 	I do not know what you do if you were shipped the wrong item 	A31A4YKVSOYRVS	
Do I need to keep a copy of the completed appraisal form 	I do not know if you need to 	A1DWQO9X2ZQ35G
I ca n't find where to change my password , can you tell me 	I do not know where to go to change your password 	A9LX66EQWDRQ5	
When I arrive at the Zoo , where do I take my online tickets 	I do not know where you take your online tickets when you arrive at the Zoo 	A2HKTM4Z8652
What is the return policy on clothing 	I do not know what the return policy is 	AD9O852KPYLHY	
How many hours are required to see the permanent collection exhibition 	I do not know how many hours are required to see the permanent collection exhibition 	A3RD486RQUI2XV
Can I host an event at the museum 	I do not know if you can host an event at the museum 	A1S8DYWNS59XWB
Why am I occasionally seeing an XFINITY WiFi notification 	I do not know why you are occasionally seeing and XFINITY WIFI notification 	ARKAJ6PL85CME
May I smoke at the Museum 	I do not know if smoking is allowed at the Museum	A2VIKCIM9TZL22
What is there for children to do at the museum 	I do not know what there is for children to do at the museum 	A3R71HP45TBQ7O
What is a product key 	I do not know what a product key is 	A1XNCA1SVTT15B
What does the title ' Prometheus ' mean 	I do not know what the title ' Prometheus ' means 	A83LGA6YEC488
How do I cancel my Hulu trial ? I 've decided it 's not for me 	I do not know how to cancel your Hulu trial 	A31A4YKVSOYRVS	
How much for the special today 	I do not know how much the special is today 	A3VV5FFG6GXE1S	
How reliable is Amazon S3 	I do not know how reliable Amazon S3 is 	A3UJE4WA5XADZS
What does Kemppi mean 	I do not know what Kemppi means 	ABN6GDFW4N8AK
How can I have the annual fee waived 	I do not know how you can have the annual fee waived 	A3SZ3W7V3GUN8Z
How do I update my personal details 	I do not know how you can update your personal details 	APC99TPURUHR8
Can I transfer employment from another local government agency 	I do not know if you can transfer employment from another local government agency 	A3G2FBKYCRD5Q8
Can you give me an overview of the Dance area 	I am not able to give you an overview of the dance area 	A3RD486RQUI2XV
I 'm not a Blues fan : should I still visit 	I do not know if you should still visit 	A3SS1F4F3JE7CU
Can you tell me what your normal store hours are 	I am not able to tell you what our normal store hours are 	A8F4B0854KTXO	
Does your hotel offer currency exchange 	I do not know if my hotel offers currency exchange 	A18RMWE4BKHG6R
If I buy a ticket online but I decide not to go , can I give it to another person	I do not know if you can give your ticket to another person if you buy it online but decide not to go 	ARKAJ6PL85CME
How do I check on my account 	I do not know how you check on your account 	AD9O852KPYLHY	
Do you plan to produce an online format 	I do not know if I plan to produce an online format 	A1JBSFXMMRGSQD
Who are your educators 	I do not know who are educators are 	A3RD486RQUI2XV
I was wondering if you could send me my purchase confirmation a second time 	I am not able to send you a purchase conformation a second time 	A1J0GU26323WVA
What animals live at the zoo 	I do not know what animals live at the zoo 	A3SS1F4F3JE7CU
Can you please check on my order for me 	I am not able to check on your order for you 	A31A4YKVSOYRVS	
When prompted , should I ' Open ' or ' Save As ' my purchased video 	I do not know what you should do 	A1DWQO9X2ZQ35G
Can I have a party in my room 	I do not know if you can have a party in your room 	A3G2FBKYCRD5Q8
Do I need a motorcycle license to ride a scooter or moped 	I do not know if you need a motorcycle license to ride a scooter or a moped 	AQ9Y6WD8O72ZC
Can I or someone else pay in advance for a reservation 	I do not know if you can pay in advance for a reservation 	A3MBQX8F0IZO7S
Is there a cash point at the Zoo 	I do not know if there is a cash point at the Zoo 	A3MFFF0TPDZQZS
Do I need to pay nonexempt employees for their lunch break if they eat at their desk 	I do not know if you need to pay nonexempt employees for their lunch break if they eat at their desk 	A16VTK6KZ1U69H
Are all the frames original 	I do not know if the frames are original 	A6ZEHD61NRBWA
Can I request faster shipping 	I do not know if you can request faster shipping 	A2H52PSYM32MG5	
What specific assistance does hospice provide patients 	I do not know what specific assistance hospice provides for patients 	A3NZLRU95OULXB
Take me off your mailing list	I am not able to take you off our mailing list 	ASFR82SJYMGNU
I am interested in applying for clerical/administrative support work . Are there any special requirements 	I do not know the special requirements 	A2NI2HSU84PHJW
Can we pre-register for Conversations 	I do not know if you can pre-register for Conversations 	A7SXWHGK8B40R
When can I arrage for the appraiser to look at the damage 	I do not know when you can arrange for the appraiser to look at the damage 	A31A4YKVSOYRVS	
What should we do when we arrive 	I do not know what you should do when you arrive 	A13GUTDMGGZZDL
How are the prices in Panama 	I do not know the prices in Panama 	A7SXWHGK8B40R
What is the installation cost for metal roofing 	I do not know the installation cost for metal roofing 	AE9M4Z1NCYSDM	
What is vanillin , or artificial vanillin , and why is it used 	I do not know what vanillin is or why it is used 	A3RKYD8IUC5S0N
What is a Rebuilt/Restored Title 	I do not know what rebuilt or restored title is 	A2NI2HSU84PHJW
The dress I ordered arrived with a tear in it ; can I get some kind of discount 	I am not able to give you a discount 	A113OGTB578EF6	
Do you accept all credit cards 	I do not know if we accept all credit cards 	A8F4B0854KTXO	
Are Firearms or weapons allowed on site	I do not know if firearms or weapons are allowed on site 	A1X3SF2W1QQBY1
What age range is the Museum designed for 	I do not know what age range the Museum is designed for 	AZLZA0Q87TJZO
Where do I go to file my case for Child Support 	I do not know where to go to file your child support case 	A1L1IRHUNKLN01
My name is spelled wrong . Are you able to fix it 	I am not able to fix the spelling of your name 	A9LX66EQWDRQ5	
Will combining everything into one shipment delay my order 	I do not know if combining everything into one shipment will delay your order	A19F9CLZ0XWBYR	
Does insurance pay for home care 	I do not know if insurance pays for home care	A23CTGXNDDW5LC
Why am I being prompted to change or verify the name that appears on my MileagePlus account 	I do not know why you are being prompted to change or verify the name that appears on your MileagePlus account 	A3G2FBKYCRD5Q8
What is the best public transportation option 	I do not know what the best public transportation option is 	A2115OWJ0CKOB3
How much is the entry fee 	I do not know how much the entry fee is 	A2LQ9NP944M61Z
What are the limitations in the name in order to obtain free . hr domain 	I do not know the limitations in the name to obtain a free . hr domain 	APC99TPURUHR8
Can I check in if the booking is under someone else 's name 	I do not know if you can check in if the booking is under someone else 's name 	A1JBSFXMMRGSQD
Can I volunteer at Deepwood 	I do not know if you can volunteer at Deepwood 	A1JBSFXMMRGSQD
How can I stay in contact with the Museum 	I do not know how you can stay in contact with the Museum 	AZLZA0Q87TJZO
Will there be a military parade 	I do not know if there will be a military parade 	A3RD486RQUI2XV
What is the price of admission 	I do not know the price of admission 	A3G2FBKYCRD5Q8
What are the performance opportunities 	I do not know what the performance opportunities are 	ABWW1P7GZ4C0Z
How do I apply for leave 	I do not know how you apply for leave 	A14M2EERU7E8KD
How much is it 	I do not know how much it is 	A2K9PB0U45O0MU
Is there Internet access in the Hotel 	I do not know if there is Internet access in the Hotel 	A7SXWHGK8B40R
If my retailer or streaming provider stops participating in UltraViolet , what will happen to my rights 	I do not know what will happen to your rights if your retailer or streaming provider stops participating in UltraViolet 	A1JBSFXMMRGSQD
What exactly is ' the story ' 	I do not know what the story exactly is 	A18RMWE4BKHG6R
Can I purchase online and have it shipped to the store 	I do not know if you can purchase online and have it shipped to the store 	AD9O852KPYLHY	
Can I exchange an item I received as a gift 	I do not know if you can exchange an item you received as a gift 	AE9M4Z1NCYSDM	
What does EFTA stand for 	I do not know what EFTA stands for 	A2NI2HSU84PHJW
What is ' People Who Bought This Item Also Bought ... ' 	I do not know what ' People Who Bought This Item Also Bought ... ' is 	A2K9PB0U45O0MU
What is the number of days before you can not return a new product 	I do not know the number of days before you can not return a new product 	A3VV5FFG6GXE1S	
With Roma Pass 72 Hours do the free entries necessarily have to be the first two admissions at museums and/or sites 	I do not know if with Roma Pass 72 Hours if the free entries necessarily have to be the first two admissions at museums and/or sites 	A2UBEPT605E8T2
Is there an indoor place where I can breastfeed my baby 	I do not know if there is an indoor place where you can breastfeed your baby 	A1JBSFXMMRGSQD
How late can I order room service 	I do not know how late you can order room service 	ASFR82SJYMGNU
What can I do if I do not have a current address 	I do not know what you can do if you do not have a current address 	AZLZA0Q87TJZO
Does milk interfere with matcha 's nutrients 	I do not know if milk interferes with matcha 's nutrients 	A2K9PB0U45O0MU
Can you set up a monthly deduction for me 	I am not able to set up a monthly deduction for you	A23CTGXNDDW5LC
Where do I call to help me find a doctor nearby 	I do not know where you should call to help you find a doctor nearby 	A1AF392CLGHH0X
Can I apply for more than one position 	I do not know if you can apply for more than one position 	A3I9FTHSULHPYS
Where can I see prices 	I do not know where you can see prices 	APC99TPURUHR8
Did I order in time to get it Friday	I do not know if you ordered in time to get it Friday 	A3GNQDFPZALU92	
What is included in the weekly cleaning service 	I do not know what is included in the weekly cleaning service 	A3GNQDFPZALU92	
Is there a grace period for late payments 	I do not know if there is a grace period for late payments 	A30YFEIPGXNWJL
What is the ultimate test drive rental	I do not know what the ultimate test drive rental is 	A1HLG5NN2I16GN
What color options are available for this product 	I do not know what color options are available for that product 	AI4AO0O0WIJF7
Can you tell me more about your checking accounts 	I am not able to tell you more about our checking accounts 	AI4AO0O0WIJF7
I am having an issue reaching my Reseller , what should I do 	I do not know what you should do 	A2K2MFQMN31DZ
What should I do if I have to cancel an appointment 	I do not know what you should do if you have to cancel an appointment 	A13GUTDMGGZZDL
How long is a Schengen visa valid for 	I do not know how long a Schengen visa is valid for 	A2NI2HSU84PHJW
Can I take the vehicle I rented into Mexico or Canada 	I do not know if you can take the rented vehicle into Mexico or Canada 	A2K9PB0U45O0MU
Can you tell me what the status of my order is 	I am not able to tell you what the status on your order is 	A9LX66EQWDRQ5	
Are there dinner and treat options available 	I do not know if there are dinner and treat options available 	A3I9FTHSULHPYS
What kind of query functionality does DynamoDB support 	I do not know what kind of query functionality DynamoDB supports 	A2NI2HSU84PHJW
Can you take my car on a trade 	I do not know if we can take your car on a trade 	A3U0VQ420HIMQ0
How do I know that the sensor is measuring me properly 	I do not know how you know that the sensor is measuring you properly 	A2HKTM4Z8652
I have an enquiry about the Dutch Museum	I do not know about the Dutch Museum 	A2TP3K1THK6XRB
How do I protect my idea 	I do not know how to protect my idea 	A1JBSFXMMRGSQD
Send me the large please	I am not able to send you the large	A23CTGXNDDW5LC	
Why are there two staff systems at the University 	I do not know why there are two staff systems 	A13GUTDMGGZZDL
I want to cancel my order 	I am not able to cancel your order 	A1IMXDZOTXABBE	
Are there any special discounts for this line of products 	I do not know if there are any special discounts for that line of products 	A1JBSFXMMRGSQD
How is food digested 	I do not know how food is digested 	A2K2MFQMN31DZ
How can I request for tax exemption on my bill 	I do not know how you can request for tax exemption on your bill 	A2HKTM4Z8652
I have a collection of fine art/paper and books/furniture/ceramics / leather/glass . How do I care for these items 	I am not able to tell you how to care for your collection of fine art/paper and books/furniture/ceramics / leather/glass 	A1J0GU26323WVA
Can I visit the store or the cafe without buying an admission ticket 	I do not know if you can visit the store or the cafe without buying an admission ticket 	A1X3SF2W1QQBY1
If I am faced with a difficult decision in a poker tournament , may I ' request time ' 	I do not know if you may ' request time '	A23CTGXNDDW5LC
Why wo n't bestups talk to my Best Fortress UPS 	I do not know why bestups wo n't talk to your Best Fortress UPS 	A7SXWHGK8B40R
Is there WiFi Internet access at the museum 	I do not know if there is WiFi Internet access at the museum 	A9LX66EQWDRQ5
Are dependents covered under a group health plan eligible for continuation coverage under the Consolidated Omnibus Budget Reconciliation Act -LRB- COBRA -RRB- 	I do not know if dependents covered under a group health plan are eligible for continuation coverage under the Consolidated Omnibus Budget Reconciliation Act -LRB- COBRA -RRB- 	A3I9FTHSULHPYS
Who do I contact with questions about inventory or maintenance coverage 	I do not know who you should contact with questions about inventory or maintenance coverage 	A3RO0QIXW4IX3Y
I was told I would be billed on the second Monday of the month but I was billed on the first this month 	I do not know why you were billed on the first this month 	A185P3B2MC2K83
Can a registered domestic partner be a dependent of his or her partner for purposes of the exclusion in section 105 -LRB- b -RRB- for reimbursements of expenses for medical care 	I do not know if a registered domestic partner can be a depenedent of his or her partner for purposes of the exclusion in section 105 -LRB- b -RRB- for reimbursements of expenses for medical care 	A3MZE4FJ658B79
What are the hotels like 	I do not know what the hotels are like 	A1AF392CLGHH0X
Could you update my email address on your system please , I 've just changed it 	I am not able to update your email address on our system 	A31A4YKVSOYRVS	
Can you explain this new charge on my bill 	I am not able to explain the new charge on your bill 	AD9O852KPYLHY	
Are there alerts or notifications available for new publications 	I do not know if there are alerts or notifications available for new publications 	A1JBSFXMMRGSQD
How can I learn about import or export licensing 	I do not know how you can learn about import or export licensing 	A7SXWHGK8B40R
What time will you arrive 	I do not know of the time I will arrive 	A2YM60MOXE9UMF
Should I bring a towel and water 	I do not know if you should bring a towel and water 	A1JBSFXMMRGSQD
When will you be seeing more of this item 	I do not know when we will be seeing more of this item 	A1D9EH4NAAP40N
What Is The Price For Private Lessons 	I do not know what the price for Private Lessons is 	A2K2MFQMN31DZ
How do I apply for a position 	I do not know how you can apply for a position 	A3G2FBKYCRD5Q8
Do you have wheelchairs available to hire 	I do not know if we have wheelchairs available for hire 	A2K9PB0U45O0MU
Can I book a one-way car rental 	I am not able to book a one-way car rental 	ARKAJ6PL85CME
Where can I find detailed information on a hotel 	I do not know where you can find detailed information on a hotel 	A7SXWHGK8B40R
We are a school or university , what is available for us 	I do not know what is available to you 	A3G2FBKYCRD5Q8
Do n't volcanoes emit more carbon dioxide than humans 	I do not know if volcanoes emit more carbon dioxide than humans 	A3RD486RQUI2XV
How can I confirm that the movie or TV show I purchased has rights stored in my UltraViolet Library 	I do not know how you can confirm that 	A298FAWY76NZA9
How do I file for Promotion Examinations Online 	I do not know how you file for Promotion Examinations Online 	A1JBSFXMMRGSQD
Would you guys do some price matching for me 	I am not able to do some price matching for you 	AMYD8PNSBQ7C2
What kinds of moving expense reimbursements or payments are taxable income to an employee 	I do not know what kinds of moving expense reimbursements or payments are taxable income to an employee 	A2NI2HSU84PHJW
Can I add my spouse to my account 	I do not know if you can add your spouse to your account 	ARCNENCVA0STW	
My pay is already in my bank account , why ca n't I see my payslip 	I do not know why you ca n't see your payslip 	A2K2MFQMN31DZ
Do you accept credit cards 	I do not know if we accept credit cards 	A13GUTDMGGZZDL
What should I do to apply for the membership 	I am not able to tell you how to apply for the membership 	AE9M4Z1NCYSDM	
What size dress did we order for my daughter	I do not know what size dress you ordered for your daughter 	A3GNQDFPZALU92	
Can you place decorations over the digital printing 	I do not know if we can place decorations over the digital printing 	A325WS381BHOHH	
Can I give my membership card to a friend or relative to use for a visit 	I do not know if you can give your membership card to a friend or relative to use for a visit 	A1A0PNOBFTTHGP
How long will it take before I get my check in the mail 	I do not know how long it will take before you get your check in the mail 	A9LX66EQWDRQ5	
Can I purchase additional nights at my resort before or after the nights included with my package	I do not know if you can purchase additional nights are your resort before or after the nights included with your package 	A1AF392CLGHH0X
Does MobileIron support delegation of administrative roles and functions 	I do not know if MobileIron supports delegation of administrative roles and functions 	A2K9PB0U45O0MU
Is the price negotiable 	I do not know if the price is negotiable 	A2K9PB0U45O0MU
As a courtesy to my customers , I sometimes hire an outside marketing company to send holiday greeting cards or advertisements about ' specials ' in my service department . To do this , I have to give the marketing company my customers ' names and addresses . I 've provided my customers with a privacy notice , but because I do n't usually disclose their information except as required by law , I have n't given them an opt-out notice . Do I now need to give an opt-out notice to my customers before disclosing this information to the marketing company 	I do not know if you need to give them an opt-out notice 	A13GUTDMGGZZDL
Can you help me get this product faster 	I am not able to help you get this product faster 	A185P3B2MC2K83
How do I pay for my field trip 	I do not know how you can pay for your field trip 	A7SXWHGK8B40R
What do you look for in student candidates 	I do not know what we look for in student candidates 	A3I9FTHSULHPYS
Are we allowed to smoke anywhere in the Zoo 	I do not know if you are allowed to smoke anywhere in the Zoo 	A8O98QNRG9SHV
May I sell merchandise related to my event 	I do not know if you may sell merchandise related to your event	A3NHJPE6326P9V
What is included in the ticket price	I do not know what is included in the ticket price 	A2EJ7U3TZAKROG
Can you tell me what products are going to be released soon 	I do not know what products are going to be released soon 	A260AFDCSXBQOH
I need to make changes to my reservation , who should I contact 	I am not able to tell you who to contact to make changes to your reservation 	A1J0GU26323WVA
Not Improving , what 's could be wrong - My child has been dancing for four years and doesnt seem to be improving . Is there something wrong 	I do not know if something is wrong 	A2HKTM4Z8652
Am I able to visit the Vatican Gardens 	I do not know if you are able to visit the Vatican Gardens 	A3UUH3632AI3ZX
Can I change my order 	I do not know if you can change an order 	AE9M4Z1NCYSDM	
Is sales tax applied to those in California 	I do not know if sales tax is applied to those in California	APF1EAZT104LQ
What type of paint is rated for exterior use 	I do not know what type of paint is rated for exterior use 	A3VV5FFG6GXE1S	
What about strollers or wheelchairs 	I am not able to tell you about strollers , or wheelchairs	APF1EAZT104LQ
Do I need to bring an ID 	I do not know if you need to bring an ID 	A3I9FTHSULHPYS
What are your busiest days 	I do not know what our busiest days are 	APC99TPURUHR8
Do you ship on Sunday 	I do not know if we ship on Sunday 	A8F4B0854KTXO	
Does it cost anything to join 	I do not know if it cost anything to join 	A3CL6GEDFNQGQY
Can I get another check book please 	I do not know if you can get another check book 	A2IXBTOWQRCLPZ	
Which free preventive services are available in the health plans through Covered California 	I do not know which free preventive services are available in the health plans through Covered California 	A3SS1F4F3JE7CU
I need to change my insurance company information on your records 	I do not know how you change your insurance company information on our records 	ARCNENCVA0STW	
What areas or locations are considered eligible for museum or historic site signs 	I do not know which areas or locations that are considered eligible for museum or historic signs 	A2K9PB0U45O0MU
Do I need to buy dance shoes for my beginning class 	I do not know if you need to buy dance shoes for your beginning class 	A2D0IIX70FDQIW
Where do tours start and end 	I do not know where tours start and end 	AT7ADQKXKXEWY
WHERE IS MY ORDER CONFIRMATION	I do not know where your order confirmation is 	A1JBSFXMMRGSQD
How do I invite the governor to speak at my school , civic group , or community organization 	I do not know how to invite the governor to speak at your school , civic group , or community organization 	ARKAJ6PL85CME
Does the AD&A Museum offer art appraisal services 	I do not know if they offer art appraisal services 	A13GUTDMGGZZDL
How do I make reservations for camping/lodging in national parks 	I do not know how you make reservations for camping/lodging in national parks 	A2K9PB0U45O0MU
How do I find my correct size 	I do not know how to find your correct size 	A13GUTDMGGZZDL
Will I receive an order confirmation 	I do not know if you will receive an order confirmation 	A13GUTDMGGZZDL
Do your gift cards have an expiration date 	I do not know if our gift cards have an expiration date	A23CTGXNDDW5LC	
Can I Learn Whatever Dance I Want 	I do not know if you can learn whatever dance you want 	ABN6GDFW4N8AK
I 'm on vacation for three weeks and would like to get my autoshipments halted 	I am not able to halt your autoshipments for three weeks 	A260AFDCSXBQOH
How do I redeem my gift card 	I do not know how to redeem your gift card 	A1YKWG46AWMPUX	
Would it be faster if I picked up the order instead 	I do not know if it would be faster if you picked up the order instead 	A3VV5FFG6GXE1S	
How do I view my orders online 	I do not know how you view your orders online 	A3G2FBKYCRD5Q8
Can you send a push notification to my phone when my item ships 	I am not able to send a push notification to your phone when the item ships 	ASFR82SJYMGNU
Will I see baby hippo Fiona on my visit 	I do not know if you will see baby hippo Fiona on your visit 	A2K9PB0U45O0MU
Why did n't I get frequent flyer credit for the miles that I flew 	I do not know why you did n't get frequent flyer credit for the miles that you flew	A23CTGXNDDW5LC
I need to have my shipment delayed for three days while I 'm away 	I am not able to delay your shipment 	AJKA9BKC011F2
Which airlines do you use and can I take a train in/out of the country 	I do not know what airlines you use and can take in/out of the country 	A7SXWHGK8B40R
Is My lawn pass valid at a PAVILION-ONLY Concert	I do not know if your Lawn Pass is valid at a Pavilion-Only concert 	AISE949ZZN8HA
What is Your Class Refund Policy	I do not know what our class refund policy is 	A3I9FTHSULHPYS
What if the student 's and teacher 's personalities do n't mesh well or the student is dissatisfied 	I do not know what to do if the student 's and teacher 's personalities do n't mesh well or the student is dissatisfied 	A3RD486RQUI2XV
I think I may have been charged twice , how do I fix this 	I do not know how you fix it 	A260AFDCSXBQOH
Is there any way that the service fee on my account could be removed 	I do not know if the service fee can be removed 	A1F04SJJSSWA1N
How do I access my loan account 	I do not know how you access your loan account 	A2YQAE441JMA7V	
How soon will a service person be available 	I do not know when the service person will be available 	AJNQ2PBD07FKE
Is an employee 's business use of a company car a working condition fringe benefit 	I do not know if an employees business use of a company car is a working condition fringe benefit 	A2K9PB0U45O0MU
Why does the International Spy Museum charge admission 	I do not know why the International Spy Museum charges admission 	A1X3SF2W1QQBY1
Do I need a visa to work in Germany 	I do not know IF YOU need a visa to work in Germany	ATQD23E8ESFSI
Q -- is the entire museum accessible to disabled visitors	I do not know if the entire museum is accessible to disabled visitors 	A5VBIZ2KIQ1R8
What is Tavern Arts 	I do not know what Tavern Arts is 	AZLZA0Q87TJZO
What if my question is not answered on this page 	I do not know what to do if your question is not answered on this page 	AJ7E01X4TAGHL
