Where are your dance classes held 	I do not know where your dance classes are held 	A3SS1F4F3JE7CU
Where can we eat 	I do not know where you can eat	ATQD23E8ESFSI
I would like to know if you let me order two personalized pizza not on the menu	I do not know if we can let you order two personalized pizzas 	AMW07CJC3OJIB
Where can I find information about materials used to make a product	I do not know where you can find information about the materials used to make a product 	A1F04SJJSSWA1N
When is this due 	I do not know when it is due 	A1YKWG46AWMPUX	
What if the weather is bad 	I do not know what the weather will be 	A2QWVKYC4RSJKM
What can my account manager do for me 	I do not know what your account manager can do for you 	A9LX66EQWDRQ5
How do I obtain warranty support on my AT&T product 	I do not know how to obtain warranty support on my AT&T product 	A2NI2HSU84PHJW
Is state income tax withholding on supplemental wages handled differently than withholding on regular wages 	I do not know IF state income tax withholding on supplemental wages ARE handled differently than withholding on regular wages	ATQD23E8ESFSI
Do you rent wheelchairs , wagons , or strollers 	I do not know if we rent wheelchairs , wagons , or strollers 	A2K9PB0U45O0MU
How do I know if I need help	I do not know how you would know if you need help 	A9LX66EQWDRQ5
I need to change my email address before I order , how do I do this 	I do not know how you do this	3VZYA8PITOQOZ67LDSBZ0Y9YFYQ50D
How do I log in to Workday 	I do not know how you log in to Workday 	A2TP3K1THK6XRB
When does your most recent product hit the shelves 	I do not know when our most recent product will hit the shelves 	A9LX66EQWDRQ5	
Is help available to researchers 	I do not know if help is available to researchers 	A235UQRA8GE18X
I need you to help me get escalated to advanced help desk for my router	I am not able to help you get escalated to advanced help desk for your router	A23CTGXNDDW5LC
How does it help me find the right candidates 	I do not know how does it help you find the right candidates 	A3SS1F4F3JE7CU
How can I tell if an email really came from USAJOBS 	I do not know how you can tell if an email really came from USAJOBS 	A2K9PB0U45O0MU
Is a job applicant protected under the National Labor Relations Act -LRB- NLRA -RRB- 	I do not know if a job applicant is protected under the National Labor Relations Act -LRB- NLRA -RRB- 	A8O98QNRG9SHV
I tried logging into your website and it 's telling me that my password is incorrect . When I reset my password , it still says ` incorrect password ' . Can you fix it 	I am not able to fix it 	3RKHNXPHGWO7XB44IMTPRUGNSDOUKP
When will you be seeing more of this item 	I do not know when we will be seeing more of this item 	A1D9EH4NAAP40N
Can my employer see the apps I 've installed 	I do not know if your employer can see the apps you 've installed 	A15UV2T9GKXSI4
What is the difference between this insurance plan and your newest one 	I do not know the difference between this insurance plan and the newest one 	A30YFEIPGXNWJL
Is the Museum open year-round 	I do not know if the Museum is open year-round 	AZLZA0Q87TJZO
The product seems to have been damaged during shipping . What are my options 	I do not know your options if the product seems to have been damaged during shipping 	AE9M4Z1NCYSDM	
What can I do about hang up calls 	I do not know what you can do about hang up calls 	A1JBSFXMMRGSQD
May an employer have its third-party benefits administrator -LRB- TPA -RRB- obtain a health plan identifier -LRB- HPID -RRB- for the employer 's self-insured plan 	I do not know if an employer can obtain a health plan identifier -LRB- HPID -RRB- for the employer 's self-insured plan 	A13GUTDMGGZZDL
What dances can I learn in private lessons 	I do not know what dances you can learn in private lessons 	A1JBSFXMMRGSQD
Will you be getting a new catalog 	I do not know if we will be getting a new catalog 	ASFR82SJYMGNU
Does Intel charge run-time fees or royalties for its libraries 	I do not know if Intel charges run-time fees or royalties for its libraries	A23OS0HQ12VVOR
How can I book a tour 	I do not know how you can book a tour 	A16VTK6KZ1U69H
I would like to use some of your recipes on my website . May I have permission to use your recipes 	I am not able to give you our permission to use our recipes on your website 	A116N2LEI6O7HB
Do you offer shipping insurance on your items 	I do not know if we offer shipping insurance on our items 	A2G9G9KF1S6X75	
When can I expect my invitation and how will it be sent 	I do not know when you can expect your invitation or how it will be sent 	A3I9FTHSULHPYS
Can I rent Deepwood for a wedding or special event 	I do not know if you can rent Deepwood for a wedding or special event 	A1JBSFXMMRGSQD
How many miles per gallon does this car get 	I do not know how many miles per gallon this car gets 	A9LX66EQWDRQ5	
Which towns does your pizza restaurant deliver to 	I do not know which towns my pizza restaurant delivers to 	A8F4B0854KTXO	
Does the no-tax-due threshold apply to the individual members of the combined group or the combined group as a whole 	I do not know if it applies to individual members or the combined group 	A13GUTDMGGZZDL
How do I dispute a charge on my credit card bill 	I do not know how you dispute a charge on your credit card bill 	A1YKWG46AWMPUX	
I have a coupon here , but I ca n't tell if it applies to everything in the store or just books . Can I use it on journals 	I do not know if you can use it on journals 	AD9O852KPYLHY	
Is there some sort of satisfaction survey I can fill out to show how helpful you 've been 	I do not know if there is a satisfaction survey 	AD9O852KPYLHY	
Will we have to wait	I do not know if you will have to wait 	A1J0GU26323WVA
What are the rental rates on your moving trucks 	I am not able to tell you the rental rates on our moving trucks 	AE9M4Z1NCYSDM	
How do I go about making a return	I do not know how you would go about making a return 	A3RD486RQUI2XV
Will it stain my swimsuit 	I do not know if it will stain your swimsuit 	A1JBSFXMMRGSQD
What 's the status on my order 	I do not know what the status is on your order 	A2YQAE441JMA7V	
What do you guys charge for shipping 	I do not know what we charge for shipping 	A31A4YKVSOYRVS	
The tracking number says delivered but I did n't get my item , what do I do 	I do not know what you do if the tracking number says delivered but you did n't get your item 	A1GAARR4GOOZCO	
Do you offer group discounts 	I do not know if we offer group discounts 	A3RO0QIXW4IX3Y
I see that there are two plans that you offer . One has a higher rate per purchase but lower percentage . Can you advise me on which I should use 	I am not able to advise you on those plans 	3B9J25CZ2559Z00C14HROALR27USCU
Does MobileIron support delegation of administrative roles and functions 	I do not know if MobileIron supports delegation of administrative roles and functions 	A2K9PB0U45O0MU
There 's no way this package should take long to deliver , where did it go off to 	I do not know where it went off to	3PIOQ99R7YE85HP7FZL5JMXRM8TUNU
How do I cancel my monthly subscription service 	I do not know how to cancel your subscription 	A1HQRT1UG6ERGL
How can I get in contact with my teacher	I do not know how can you get in contact with your teacher 	A3SS1F4F3JE7CU
Can you tell me who the owner of the hardware store is 	I am not able to tell you who the owner is 	3YD0MU1NC2TZNNJMTNNPNOZ7FQX7AL
Is there a limit to the number of applications I can submit 	I do not know if there is a limit to the number of applications you can submit 	A2LQ9NP944M61Z
Where can I find class prices 	I do not know where you can find class prices 	A1X3SF2W1QQBY1
I want to have my scheduled pickup come a week later instead of tomorrow , I have too much going on	I do not know if you can change your scheduled pickup 	3IWA71V4TI8SF0DALNAB1IA9L0M6XP
I need to call my sons school , Can you give me the number 	I do not know the phone number for the school 	32FESTC2NHIPEDSGQ9CR3B3FN4FUCC
When responding to a charge by the Equal Employment Opportunity Commission -LRB- EEOC -RRB- or a state fair employment agency , should an employer provide its entire handbook or full policies in support of its position 	I do not know if an employer should provide its entire handbook or full policies in support of its position 	A2NI2HSU84PHJW
What is HIPAA 	I do not know what HIPAA is 	A1JBSFXMMRGSQD
Are the green grapes the best	I do not know if the green grapes are the best 	A31A4YKVSOYRVS	
Can you help me order this as a gift for my grandma 	I am not able to help you order that as a gift for your grandma	AJ7MWBQFNH3E4
What is Beiersdorf 's attitude regarding sustainability 	I do not know what Beiersdorf thinks about sustainability	APF1EAZT104LQ
Can you tell me if you have waist sizes for men above 46 	I do not know if we have waist sizes for men above 46 	AD9O852KPYLHY	
Do you accept Discover card 	I am not able to accept Discover card	A23CTGXNDDW5LC
How do I select vendors for my event 	I do not know how you select vendors for your event 	A1JBSFXMMRGSQD
I forgot to cancel my trial subscription but no longer want this service , is their anyway to reverse these charges 	I am not able to reverse the charges 	3DGDV62G7O1ZOQSICUORHS7U3WB2PG
Can we spend the night in an RV in the Zoo 's parking area 	I do not know if you can spend the night in an RV in the Zoo 's parking area 	A13GUTDMGGZZDL
How can I purchase my membership online if I prefer not to use my personal credit card information	I am not able to tell you how you can purchase your membership online if you prefer not to use your personal credit card information 	A116N2LEI6O7HB
When can I expect to see the charge placed on my card 	I do not know when you should expect to see the charge	APF1EAZT104LQ
Where did the configuration tools go 	I do not know where the configuration tools go 	A1IMICF9ISISZN
I need to renew my loan 	I do not know how to renew your loan 	AE9M4Z1NCYSDM	
How can I follow you on Facebook 	I do not know how you can follow us on Facebook	AYJGJAIY0EXW
What if I make a mistake 	I do not know what you can do if you make a mistake 	A2VIN0EE9BGPSH
How do I change information submitted on my online application 	I do not know how you change information submitted in your online application 	A16NITTBMCSN0V
Do I have to pay an employee for unused sick time 	I do not know if you have to pay an employee for unused sick time 	A1J0GU26323WVA
Is Kemppi active in every continent 	I do not know if Kemppi is active in every continent 	A3I9FTHSULHPYS
What are random bag checks 	I do not know what random bag checks are 	A1J0GU26323WVA
How do I make corrections to prior time sheets 	I do not know how you make corrections to prior time sheets 	A1X3SF2W1QQBY1
I ca n't make it in person to pick up some packages . Could I have someone else come by and collect them for me 	I am not able to have someone come and pick up your packages 	3UOMW19E6DY8TY21P84JVZBZONN5C6
How do I add a family member to my benefits 	I do not know how you can add a family member to your benefits 	A13GUTDMGGZZDL
Does the Spanish version of the Form I-9 contain the same features as the English smart version 	I do not know if the Spanish version of the Form I-9 contains the same features as the English smart version 	A1X3SF2W1QQBY1
How can I reschedule a flight I booked ? This one I booked is n't going to be needed anymore for me 	I do not know how you can reschedule a flight you booked	3T8DUCXY0NY8G26OEKCQWPG5Y569TK
Can I return this car at 3 PM instead of 4 PM 	I do not know if you can return this car at 3 PM instead of 4 PM 	A325WS381BHOHH	
What do I need to do after completing booking 	I do not know what to do after you complete booking 	A2115OWJ0CKOB3
What legislation affects benefits 	I do not know what legislation affects benefits 	AFS36YMNN8A2J
I need to add a spouse to my policy 	I am not able to add your spouse to your policy 	A31A4YKVSOYRVS	
What qualifications stand me in good stead for finding a job in Germany 	I do not know what qualifications stand you in good stead for finding a job in Germany 	A16VTK6KZ1U69H
What is the price of admission 	I do not know the price of admission 	A3G2FBKYCRD5Q8
How many people are attacked each year by sharks 	I do not know how many people are attacked by sharks each year	A3NZLRU95OULXB
Can you help me with my account ? It is blocked	I am not able to help you with your blocked account 	A9LX66EQWDRQ5	
How can I book Dorint Hotels & Resorts 	I do not know how you can book Dorint Hotels & Resorts 	A1J0GU26323WVA
How can I check to see which of my dependents I am covering 	I do not know how you can check to see which dependents you are covering 	A2K9PB0U45O0MU
If I am a Member , do I receive free admission to SMoCA 	I do not know if you receive free admission to SMoCA 	A2NI2HSU84PHJW
What do fossils have in common with paintings , and scientific instruments with coins 	I do not know what fossils have in common with paintings , and scientific instruments with coins 	A2K9PB0U45O0MU
What are your payment options	I do not know what the payment options are 	A13GUTDMGGZZDL
What services do the film commissions provide 	I do not know what services the film commissions provide	APF1EAZT104LQ
How can I order more of that fabulous product 	I do not know how to order more product 	AJ7MWBQFNH3E4
Do you offer any senior , student , or military discounts 	I am not able to tell you if we offer any senior , student , or military discounts 	A1JBSFXMMRGSQD
So this customer is trying to purchase this lamp but it does n't have a UPC code on it , do I go to the back and find another one just like it to scan 	I do not know if you should find another one or not 	3KWGG5KP6JU615N7H7L5C1MLAIDCM3
Do you walk my dog with other people 's dogs 	I do not know if we do 	A1DWQO9X2ZQ35G
Can I park my car at the Miffy Museum 	I do not know if you can park your car at the Miffy Museum 	A3O4VPJT4GOBMB
Is there a place to eat in the museum 	I do not know if there is a place to eat in the museum 	A2NI2HSU84PHJW
Please email me an application for a new account 	I am not able to email you an application for a new account 	A31A4YKVSOYRVS	
What is an ASO 	I do not know what an ASO is 	A1J0GU26323WVA
Are all downloadable images of artworks on The Met 's website suitable for publication 	I do not know if all downloadable images of artworks on The Met 's website are suitable for publication 	A3CL6GEDFNQGQY
Is the venue handicap and wheelchair accessible	I do not know is the venue handicap and wheelchair accessible 	A3SS1F4F3JE7CU
I submitted an application several months ago , but never heard anything back . Is there a still a chance that I could volunteer	I do not know if there is a chance you could still volunteer 	A2K9PB0U45O0MU
Can we build our own HR reports 	I do not know if you can build your own HR reports 	A3G2FBKYCRD5Q8
Can I get a discount if I order large quantities 	I do not know if you can get a discount if you order in large quantities 	AD9O852KPYLHY	
If an employee is fired unexpectedly , how can the employer satisfy state law requiring the employer to pay the employee immediately 	I do not know how the employer can satisfy state law requiring the employer to pay the employee immediately if the employee is fired unexpectedly 	A1J0GU26323WVA
What if the database does not contain the name of the person I am looking for 	I do not know what to do if the database does not contain the name of the person you are looking for 	A3CL6GEDFNQGQY
Can you please check if the item ingredients are the same as the previous version 	I am not able to check if the item ingredients are the same as the previous version 	A9LX66EQWDRQ5	
I forgot my user ID and/or password , what do I do 	I do not know what you do	A23CTGXNDDW5LC
Do you have a museum store	I do not know if we have a museum store 	A7SXWHGK8B40R
Was my complaint reveiwed by a manager 	I do not know if your complaint was reviewed by a manager 	A2EAJXBORHT44T	
What types of spiritual care services are available 	I do not know the types of spiritual care services that are available 	A2VIKCIM9TZL22
Where is ' Meet the Animals ' 	I do not know where ' Meet the Animals ' is 	A8O98QNRG9SHV
Do you sell matcha in tea bags 	I do not know if we sell matcha in tea bags 	A3SS1F4F3JE7CU
How do I view my upgrade eligibility status from my device 	I do not know how you view your upgrade eligibility status from your device 	A235UQRA8GE18X
How do I register for PACER 	I do not know how you would register for PACER 	A16NITTBMCSN0V
What do I do if I think I might be having a stroke 	I do not know what you do if you think you might be having a stroke 	A3R71HP45TBQ7O
If an employee resigns with two-weeks ' notice , and we tell the employee to leave prior to the end of the two-week period , are we obligated to pay the employee for the full two weeks 	I do not know if you are obligated to pay the employee for the full two weeks 	A7SXWHGK8B40R
What are the requirements for applying for a residence card , or for the issue of an address card 	I do not know what the requirements are for applying for a residence card , or for the issue of an address card 	A7SXWHGK8B40R
What will I see in the Museum 	I do not know what you well see in the museum 	A2LQ9NP944M61Z
What is a Flexible Spending Account -LRB- FSA -RRB- 	I do not know what a Flexible Spending Account -LRB- FSA -RRB- is 	AZLZA0Q87TJZO
May I loan my membership card to my mother , sister , nanny , etc. 	I do not know if you may loan your membership card to your mother , sister , nanny , etc. 	A2EJ7U3TZAKROG
How long does it usually take to ship this product 	I do not know how long it usually takes to ship this product 	AE9M4Z1NCYSDM	
Does your company provide a shuttle back to the airport when I return 	I am not able to tell you if we provide a shuttle	APF1EAZT104LQ	
Are returns allowed even if the product is n't damaged 	I do not know if returns are allowed even if the product is n't damaged 	AE9M4Z1NCYSDM	
How does the warranty on my product work 	I do not know how the warranty on your product works 	A1YKWG46AWMPUX	
Does the BioPark accept pet donations 	I do not know if the BioPark accepts pet donations 	A3G2FBKYCRD5Q8
Do we have to change partners during group classes 	I do not know if you have to change partners 	A13GUTDMGGZZDL
Does your ice cream shop offer dairy free options 	I do not know if we offer dairy free options 	A9LX66EQWDRQ5	
How can I place an order using my tax exempt number 	I do not know how you can place an order using your tax exempt number 	A5VBIZ2KIQ1R8
How much can I save by bundling all my insurance items together 	I do not know how much you can save by bundling your insurance items together 	A1YKWG46AWMPUX	
Do I get a discount if I preorder an item 	I do not know if you get a discount if you preorder an item 	A8F4B0854KTXO	
How do I renew my membership 	I do not know how you renew your membership 	A3I9FTHSULHPYS
Why does the museum charge admission	I do not know why the museum charges admission 	A1A0PNOBFTTHGP
I would like someone to explain the specs of the products as I am totally new to this 	I am not able to explain the specs of the products 	A3FIJGXCWIHHQ5	
Do you have a preferred customer program 	I do not know if we have a preferred customer program	A23CTGXNDDW5LC	
Is there a group rate or a family rate 	I do not know if there isa group rate or a family rate	A23CTGXNDDW5LC
What is the minimum GRE score 	I am not able to tell you the minimum GRE score 	AT7ADQKXKXEWY
Can I take photographs in the museum using , for example , a digital camera 	I do not know if you can photographs using a digital camera 	A13GUTDMGGZZDL
What if I do n't like the vehicle that I have a deposit for or I have purchased another vehicle 	I do not know what car you have a deposit for 	A3722NOMVUK89T
Can I speak to a manager 	I do not know if you can speak to a manager	A23CTGXNDDW5LC
I only have one good hand . Is the Zinger for me 	I do not know if the Zinger is for you 	A1XNCA1SVTT15B
Will you accept orders to Canada 	I am not able to accept orders to Canada 	A3RD486RQUI2XV
I scheduled a payment through the app but I need to change the amount . Can you help me with this 	I am not able to help you with this	30U1YOGZGAOJ4S6Q10C28G39N76SDU
What are the opening times / events on at St Katherine 's Heritage Centre , Canvey Island	I am not able to tell you the opening times / events on at St Katherine 's Heritage Centre , Canvey Island 	A2UBEPT605E8T2
Do you have any free , or donation based hours 	I do not know if we have any free or donation based hours 	A2HKTM4Z8652
What kinds of research materials are available at the Library 	I am not able to tell you what kinds of research materials are at the library 	APF1EAZT104LQ
Q -- is the entire museum accessible to disabled visitors	I do not know if the entire museum is accessible to disabled visitors 	A5VBIZ2KIQ1R8
Can Cardio Dance really work as a gym replacement 	I do not know if Cardio Dance can work as a gym replacement 	A3GVKU8KSX3RZU
What 's included in the cost of the course 	I do not know what is included in the cost of the course 	A2VFX3J4B1I22X
Do I have to inform you if in my group there are children under 6 years of age 	I do not know if you have to inform us if in your group there are children under 6 years of age 	A3I9FTHSULHPYS
What does ' Use Your Lid ' Mean 	I do not know what ' Use Your Lid ' means 	A13GUTDMGGZZDL
What type of attention can my child expect to get while in class 	I do not know what type of attention you child can expect to get 	A325WS381BHOHH
Do I have to sign a contract to have your service 	I do not know if you have to sign a contract to have our service 	ASFR82SJYMGNU
May an employer make up for a wage overpayment by paying the employee less in the next wage payment 	I do not know if an employer can make up for a wage overpayment by paying the employee less in the next wage payment 	A2HKTM4Z8652
Are there guided tours of the Fashion Museum 	I do not know if there are guided tours of the Fashion Museum 	A16NITTBMCSN0V
Will I be charged for my car reservation in advance 	I do not know if you will be charged for your car reservation in advance 	A2EJ7U3TZAKROG
How can an employer minimize the risk of family responsibility discrimination claims 	I do not know how an employer can minimize the risk of family responsibility discrimination claims 	A2UBEPT605E8T2
Can I confirm my flight over the phone 	I am not able to confirm your flight over the phone 	A3GNQDFPZALU92	
I already placed an order , can I add to it 	I do not know if you can add to your order 	AD9O852KPYLHY	
What is the purpose of the GT Key 	I do not know the purpose of the GT key 	A2VIKCIM9TZL22
When will you get this item back in stock 	I do not know when this item will be back in stock 	AD9O852KPYLHY	
How are levels of classes and teams chosen 	I do not know how classes and teams are chosen 	A1HLG5NN2I16GN
Can you tell me where my order is 	I am not able to tell you where your order is 	AJKA9BKC011F2
Your items are made in any number of countries , can I specifiy the country of origin I want my item to be from 	I do not know if you can specify the country of origin you want your item from 	AE9M4Z1NCYSDM	
It says my package was lost in transit . When can I receive my refund 	I do not know when you can receive your refund 	AD9O852KPYLHY	
Can we bring outside food into the Museum 	I do not know if you can bring outside food into the museum 	A2VIKCIM9TZL22
Will my information be secure with your company	I do not know if your information will be secure 	AJNQ2PBD07FKE
When must an employer include the fair market value of an employee 's personal use of a company-provided cell phone in the employee 's taxable income 	I do not know when an employer must include the fair market value of an employee 's personal use of a company-provided cell phone in the employee 's taxable income 	A2NI2HSU84PHJW
Is there is a way to limit an individual 's data use with The Verizon Plan 	I do not know if there is a way to limit an individual 's data with The Verizon Plan 	A2NI2HSU84PHJW
I lost my pass and need a replacement . What should I do	I do not know how you should get a replacement pass 	A2VIKCIM9TZL22
I was supposed to get a certificate of authentication along with my painting , but it never came . Are you guys able to send me an official one ? If not I will need to return this work of art 	I do not know if we can send a certificate of authentication 	3JAOYN9IHLUH2JJEIW5PNZ9L4EJ33G
When will the next drop shipment arrive for my company 	I do not know when the next drop shipment will arrive for your company 	A1JBSFXMMRGSQD
I 'd like to upload some documents to my account but I 'm not sure how . Can you tell me 	I am not able to tell you how to upload document 	3VEI3XUCZRPGSA93RK3SI0F2FOQPRH
Where are the best places to go shopping in London 	I do not know the best places to go shopping in London 	A16NITTBMCSN0V
What are the benefits of Family Membership 	I do not know what are the benefits of Family Membership 	A3SS1F4F3JE7CU
Is it possible to get the professional diploma which I obtained abroad recognised 	I do not know if it 's possible to get the professional diploma you obtained abroad recognised 	A2VIKCIM9TZL22
How do I contact the Office of Graduate Studies 	I do not know how you contact the Office of Graduate Studies 	A7SXWHGK8B40R
After I have applied online , how can I contact a hiring manager or a recruiter 	I do not know how you can contact a hiring manager or a recruiter 	A3G2FBKYCRD5Q8
How can we book our school group or birthday party 	I do not know how you can book your school group or birthday party 	A2NI2HSU84PHJW
Can I pay for my program reservation on account 	I do not know if you can pay on account 	A13GUTDMGGZZDL
Do you place an incidental hold on my credit card when I check in	I do not know if we place an incidental hold 	A13GUTDMGGZZDL
Can I make changes to my reservation after I have purchased it 	I do not know if you can make changes to your reservation 	A2NI2HSU84PHJW
I do n't know what shops are in my area that can fix my car can you help me look up a couple and provide me their phone numbers 	I am not able to look up shops or provide their phone numbers 	3NCN4N1H1G9T9IG1F84AEW53XNMNB6
Can visitors park in the streets around the Zoo 	I do not know if visitors can park in the streets around the zoo 	A13GUTDMGGZZDL
I made a online purchase a few minutes ago but did not get a confirmation email . Would you be able to track my order and re-send that email to me 	I am not able to track your order and re-send that email to you	3ZFRE2BDQ96U3AXLNS7MYG34Q4IZX8
How can I update my information online 	I do not know how you can update your information online 	ARCNENCVA0STW	
Can you change my shipping from expedited to standard 	I am not able to change your shipping from expedited to standard 	A3GNQDFPZALU92	
Can I pay by check or money order 	I do not know if you can pay by check or money order 	A83LGA6YEC488
Where can I find my XFINITY username and password 	I do not know where you can find your XFINITY username and password 	A3CL6GEDFNQGQY
Can I order tickets by phone or online 	I do not know if you can order tickets by phone or online 	A1JBSFXMMRGSQD
Do you guys have a mobile app 	I do not know if we have a mobile app 	A2IXBTOWQRCLPZ	
What is the capacity for an event 	I do not know the capacity for an event 	A1JBSFXMMRGSQD
Are your products ethically sourced 	I do not know if our products are ethically sourced 	A1F04SJJSSWA1N
What English language qualifications do I need 	I am not able to tell you what english language qualifications you need	A3EMEMWJDM5DAR
Is e-cigarette use protected by state laws prohibiting discrimination against employees for engaging in legal off-duty activities 	I do not know if e-cigarette use is protected by state laws prohibiting discrimination against employees for engaging in legal off-duty activities 	A3U0VQ420HIMQ0
I have a museum card . Do I still need to make a reservation 	I do not know if you need it to make a reservation 	A13GUTDMGGZZDL
I purchased an airline ticket to Hawaii and my flight has been canceled due to a Hurricane heading there . How can I reschedule my flight 	I do not know how to help you reschedule your cancelled flight to Hawaii 	3GL25Y6843MU43Y283HSQE7VB00XMP
Has the museum opened 	I do not know if the museum has opened 	A3I9FTHSULHPYS
I would like to apply for your store card 	I am not able to help you apply for our store card 	A3RD486RQUI2XV
Can I access my car once in the Zoo 	I do not know if you can access your car once in the zoo 	A2NI2HSU84PHJW
When will you be offering more of this item 	I do not know when we will be offering more of this item	A23CTGXNDDW5LC
Do you hire out wheelchairs , mobility scooters or pushchairs 	I am not able to hire out wheelchairs , mobility scooters , or pushchairs 	ARKAJ6PL85CME
Will I get notification 24 hours in advance about my appointment via text message	I do not know if you will get a notification 24 hours in advance about your appointment via text message 	301KG0KX9CD7B9UUTHGM8J53H512HB
How often should I use Wag 	I do not know how often you should use Wag 	A2K9PB0U45O0MU
What is the latest date that I can arrive in Ireland with my Visa 	I am not able to tell you the latest date you can arrive in Ireland with your Visa 	A355BVFIOODRH2
How do I remove an ineligible dependent who does not meet the eligibility definition 	I do not know how to remove an ineligible dependent 	ABN6GDFW4N8AK
Can I bring a pet 	I do not know if you can bring a pet 	AZLZA0Q87TJZO
I returned a package but it has n't been credited to my account yet . Can you tell whether it was done 	I am not able to tell whether the credit has been made to your account yet 	371Q3BEXDH1M7TBMTI1ZZ8MCBPGZS0
Do I have flood insurance ? If so , can I file a claim ? If not , can I get some for yesterday 	I do not know if you have flood insurance	30UZJB2POH4KGY6IWFTI2W75IAA356
I 'm a member of a museum that offers NARM reciprocity . What are my benefits at M * AR 	I do not know what your benefits are at M * AR 	A9LX66EQWDRQ5
What is the smoking policy at the Zoo 	I do not know the smoking policy at the zoo	A16184N1RO5OJV
Is there an early departure fee 	I do not know if there is an early departure fee 	A3I9FTHSULHPYS
What are my payment options 	I do not know what your payment options are 	A325WS381BHOHH	
How can I track orders Shipped by Newegg 	I do not know how you can track orders shipped by Newegg 	A2LQ9NP944M61Z
What is the volunteer commitment 	I do not know what the volunteer commitment is 	ARKAJ6PL85CME
I would like to get an invoice sent along with my order 	I am not able to sent you an invoice along with your order 	ASFR82SJYMGNU
How does brown sugar differ from white sugar 	I do not know how brown sugar differs from white sugar 	A9LX66EQWDRQ5
Are there security features for additional users 	I do not know if there are security features for additional users 	A2866TYG0D96LM
How large are class sizes 	I do not know how large class sizes are 	A2K2MFQMN31DZ
Can I return this to any store 	I do not know if you can return this to any store 	ASFR82SJYMGNU
Can I exchange items for store credit	I am not able to exchange items for store credit	A1SNC8UL8YFRH5
Is the use of virtual credit cards for health care claim payments covered by HIPAA transactions requirements 	I do not know if the use of virtual credit cards for health care claim payments are covered by HIPAA transactions requirements 	A2I4VNAS21FXCE
Does your hotel offer free airport shuttle service 	I do not know if our hotel offers free airport shuttle service 	A3GNQDFPZALU92	
I need to correct the spelling of my name on my account 	I am not able to correct the spelling of your name on your account 	A9LX66EQWDRQ5	
I need help with my cart	I am not able to help with your cart 	A2TKHXY755FAM
If I ordered an item online can I return it in store	I am not able to tell you if you ordered an item online whether you can returni it in store	AYJGJAIY0EXW
I 'm new to the area . Can you send me a list of local restaurants 	I am not able to send you a list of local restaurants 	3R5LWXWHR00UCT2GX0JXD9NYFEOXGH
When do I need to provide my financial statement 	I do not know when you need to provide your financial statement 	A16VTK6KZ1U69H
My question is about my current premium . I noticed that I can actually pay a lower premium if I switch to a dual vehicle policy , is that right 	I do not know if you will pay a lower premium 	3MG8450X2O28821KVEYXNB2MMNUPUL
When will this item be back in stock 	I do not know when this item will be in stock 	AADRVG2QVZH75	
How do I get census records 	I do not know how you can get census records 	A2UBEPT605E8T2
I 'd like to order your as seen on t.v. product but I do not have a credit card . Do you accept C.O.D. orders 	I do not know if we accept C.O.D. orders 	3ZG552ORAMWCTAPEY6XQNKWCPKC2V1
Do I have to print my tickets 	I do not know if you have to print your tickets 	AXY0D2AMLKE2A
How do I purchase tickets online 	I do not know how you purchase tickets online 	A1J0GU26323WVA
I 'm a classically trained dancer , can I take an advanced/challenging class	I do not know if you 're a classically trained dancer if you can take an advanced/challenging class 	A1JBSFXMMRGSQD
How can I find a physical store location 	I am not able to find you a physical store location 	A112W2FKT6UT62
Could you please check on the status of my order 	I am not able to check on the status of your order 	AD9O852KPYLHY	
Are mashed potatoes a real pizza topping 	I do not know if mashed potatoes are a real pizza topping 	A20WRVVT7WQFT7
My child got on my computer and bought something that I do n't want , I need to cancel this order 	I am not able to help you cancel the order 	A325WS381BHOHH	
When will a new tour open 	I do not know what a new tour will open 	A13GUTDMGGZZDL
Can I get the status of my order 	I am not able to provide the status of your order 	AYJGJAIY0EXW
Will we need to purchase dancing shoes	I do not know if we will need to purchase dancing shoes 	A1THXHPVWVEWNZ
Can my bill due date be extended by two weeks 	I do not know if your bill due date can be extended by two weeks	AYJGJAIY0EXW
What Is Fool 's Gold 	I do not know what Fool 's Gold is 	A1J0GU26323WVA
Where do I go to report for jury duty 	I do not know where you go to report for jury duty 	A7SXWHGK8B40R
How does one change the delivery schedule for an item they ordered ? I wo n't be there to pick it up unfortunately 	I do not know how one changes the delivery schedule for an item they ordered	3G9UA71JVVMAOGMQNT02GN2Q5DR7J1
How often do you update your physical catalog 	I do not know how often we update our physical catalog	A23CTGXNDDW5LC
Are you the National Park Service 	I do not know if we are the National Park Service	A23CTGXNDDW5LC
How secure is my data with HeavenHR 	I do not know how secure your data with HeavenHR 	A3CL6GEDFNQGQY
Is the hardware to assemble the kit included 	I do not know if the hardware to assemble the kit is included 	AD9O852KPYLHY	
What will happen after I apply 	I do not know what will happen after you apply 	A7SXWHGK8B40R
Can Dealer Teamwork update the specials for me 	I do not know if a Dealer Teamwork can update the specials for you 	A2K9PB0U45O0MU
What is group therapy like	I do not know what group therapy is like 	A30YFEIPGXNWJL
When do hospitals have to meet the Medicaid meaningful use requirements 	I do not know when hospitals have to meet Medicaid meaningful use requirements	APF1EAZT104LQ
I want this invoice sent to my fax 	I am not able to send the invoice to your fax 	A3O81LHBBI8NPK
Can I have an independent inspection done on the car before I buy it 	I do not know if you can have an independent inspection done 	A2NI2HSU84PHJW
I made a mistake in ordering some items and want to get a refund on the purchase I made . Can you guide me through this 	I am not able to guide you through this	3JMQI2OLFZXMOFELT4VG9MT308YNDD
What if you 're rental car is n't filled when I pick it up 	I do not know what you do if your rental car is n't filled when you pick it up 	AE9M4Z1NCYSDM	
If I buy a ticket online but I decide not to go , can I give it to another person	I do not know if you can give your ticket to another person if you buy it online but decide not to go 	ARKAJ6PL85CME
I am a Member . Can I park for free 	I do not know if you can park for free	A23CTGXNDDW5LC
I see movies and TV shows available on my retailer 's website for purchase that are not listed as UltraViolet . Why 	I do not know why those movies are not on UltraViolet	APF1EAZT104LQ
Where are the butterflies 	I do not know where the butterflies are 	APC99TPURUHR8
What is the temperature going to be like during my stay 	I do not know what the temperature is going to be like during your stay 	A116N2LEI6O7HB
Can you help me with my class project 	I am not able to help you with your class project 	AFS36YMNN8A2J
I would like to place an order , but the website does n't seem to be working properly right now 	I am not able to help you place an order 	3X0EMNLXEPH8LHQK0482JX450U3PVA
Where can I confirm my ANA SKY COIN balance 	I do not know where you can confirm your ANA SKY COIN balance 	A2K9PB0U45O0MU
How do I get on your mailing list 	I do not know how you get on our mailing list	A23CTGXNDDW5LC	
How many coupons are accepted per order 	I do not know how may coupons are accepted per order 	A1CQPRZUT6BW44
I received a call from this number , is this the car place ? I need a replacement part 	I do not know if this is the car place	3JUDR1D0D6JKO2TXC73GHXX48SWQ2U
I am trying to take an assessment online but the website does not work , can i do it over the phone with a agent 	I do not know if you can do the assessment over the phone with an agent 	3HEADTGN2PKTXU6ZDWCROS4K1CRRV4
My order says it was delivered but I never received it 	I am not able to help you with your order 	A325WS381BHOHH	
How recent is your data 	I do not know how recent it is 	A1DWQO9X2ZQ35G
What if some of my employees do n't have access to the internet 	I do not know what to do if some of your employees do n't have access to the internet 	APC99TPURUHR8
How do I report the sale of my second residence 	I do not know how you can report the sale of your second residence 	A8O98QNRG9SHV
Does your house insurance cover termite damage	I do not know if our house insurance covers termite damage 	AD9O852KPYLHY	
What items of clothing qualify 	I do not know what items of clothing qualify 	AZLZA0Q87TJZO
My electronic tax return keeps getting rejected because a dependent 's social security number is used more than once on one return or is used on another return . What should I do 	I do not know what you need to do to fix this rejection 	APF1EAZT104LQ
Is the carousel operating today 	I do not know if the carousel is operating today 	A3U6CLX7HD0SMF
Where do I call to help me find a doctor nearby 	I do not know where you should call to help you find a doctor nearby 	A1AF392CLGHH0X
If I do n't have a diverse pool of applicants what can I do 	I do not know what can be done if you do n't have a diverse pool of applicants 	A234VIHHUHPZG5
Are there age restrictions 	I do not know if there are age restrictions 	A13GUTDMGGZZDL
Can you check on the status of my rebate 	I am not able to check on the status of your rebate 	A325WS381BHOHH	
How should a retailer handle items normally sold as a unit 	I do not know how a retailer should handle items normally sold as a unit	A23CTGXNDDW5LC
Are there any federal Indian reservations in Alaska 	I do not know if there are any federal Indian reservations in Alaska 	AZLZA0Q87TJZO
Can someone from outside of UCSB -LRB- including other UC campuses -RRB- donate vacation time to an eligible employee through the Catastrophic Leave Sharing Program 	I do not know if someone from outside of UCSB -LRB- including other UC campuses -RRB- can donate vacation time to an eligible employee through the Catastrophic Leave Sharing Program 	A1J0GU26323WVA
Will we be able to log into Workday through the college homepage 	I do not know if you will be able to 	A1DWQO9X2ZQ35G
Does BAMPFA have a lost and found 	I do not know if they have a lost and found 	A13GUTDMGGZZDL
My order has not arrived yet	I do not know why your order has not arrived yet 	A2TKHXY755FAM
Why does my hamster need an exercise wheel 	I do not know why your hamster needs an exercise wheel 	A7SXWHGK8B40R
Are there any fees associated with backdating my account under The Verizon Plan 	I do not know if there are any associated fees with backdating your account under The Verizon Plan 	A2NI2HSU84PHJW
Can I leave the site and come back in if I 'm a VIP or Platinum customer 	I do not know if you can leave the site and come back in if you are a VIP or Platinum customer 	A3CL6GEDFNQGQY
What color does that blender come in ? Can I choose 	I do not know if you can choose	32LAQ1JNT9H60UURCV7HSL3JBQFUTV
When is it necessary to have the place of accommodation notified , and how it is done 	I do not know when it is necessary to have the place of accommodation notified , or how it is done 	A3G2FBKYCRD5Q8
Can I reset my pin 	I do not know how to reset your pin 	AE9M4Z1NCYSDM	
How can I , as an employee , prepare myself to conduct a performance appraisal 	I do not know how you , as an employee , can prepare yourself to conduct a performance appraisal 	A2K9PB0U45O0MU
Do employees say negative things in Know Your Company 	I do not know if employees say negative things in Know Your Company 	A2K9PB0U45O0MU
My name is spelled wrong . Are you able to fix it 	I am not able to fix the spelling of your name 	A9LX66EQWDRQ5	
How long does it take to visit Henry Ford Museum of American Innovation 	I do not know how long it takes	AXY0D2AMLKE2A
How do I set up an online bridal registry 	I am not able to tell you how to set up an online bridal registry 	AE9M4Z1NCYSDM	
What digital products do you have 	I am not able to tell you what digital products we have 	A31A4YKVSOYRVS	
Are only workers who are currently pregnant protected under federal law 	I do not know if only workers who are currently pregnant are protected under federal law 	A1199EKUWHAKUQ
How can I confirm that the movie or TV show I purchased has rights stored in my UltraViolet Library 	I do not know how you can confirm that 	A298FAWY76NZA9
What do I do if I lost my membership card 	I do not know what you should do if you lost your membership card 	A9LX66EQWDRQ5
What is the phone number of your locate chain store 	I do not know the phone number of our locate chain store 	A8F4B0854KTXO	
Is there a paper application or a sample application 	I do not know if there is a paper or sample application 	A13GUTDMGGZZDL
I hear there is a security interview before my flight 	I am not able to tell you if there is a security interview before the flight	APF1EAZT104LQ
What is the Dorint Card 	I do not know what the Dorint Card is	A23CTGXNDDW5LC
How old do I have to be to gamble 	I do not know the age in which its legal to gamble 	A16NITTBMCSN0V
How does one get a refund on an item that is n't functioning properly ? It 's important this works for me	I do not know how you get a refund 	3OYHVNTV5TQCK6K7M0HGSOOYAR0KO2
Can I take it on the Plane 	I do not know if you can take it on the Plane 	AZLZA0Q87TJZO
Are There Any Membership Fees 	I do not know if there are any membership fees 	A9LX66EQWDRQ5
I am vegetarian . What menu items can I eat 	I do not know what menu items you can eat 	A3G2FBKYCRD5Q8
How long is the audition class 	I do not know how long the audition class is 	A30YFEIPGXNWJL
How often do the exhibits change 	I do not know how often the exhibits change 	A13GUTDMGGZZDL
Am I required to attend orientation to sign up for benefits 	I do not know if you required to attend 	AOPI4DCPSO8H4
What do I do with my coat or large bag 	I do not know what you should do with your coat or bag 	ALDKJ42AAASLI
Where is the zoo located 	I do not know where the zoo is located 	A16VTK6KZ1U69H
Why do you ask for my phone number when I 'm enrolling in MileagePlus 	I do not know why we ask for your phone number when you are enrolling in MileagePlus 	A1J0GU26323WVA
I wo n't be able to pick up my order until tomorrow , but I scheduled it for pickup today . Can we change this 	I am not able to change your order schedule 	AKQ23WWJ57B8R	
What kind of activities the Museum have 	I do not know what kind of activities the Museum has 	AZLZA0Q87TJZO
What is going to happen to current DACA holders 	I do not know what is going to happen to current DACA holders 	A1JBSFXMMRGSQD
My account information was added wrong to my mortgage company , can we fix this error 	I am not able to fix this account error 	3PUOXASB57V42EFNKC18IDHMJ1S9Z0
When can I expect my package 	I do not know when you can expect your package 	AD9O852KPYLHY	
What is the quickest , most effective way to learn to dance 	I do not know the quickest and most effective way to learn to dance 	A1XNCA1SVTT15B
Do you have any boxes in the back that I can take home 	I do not know if we have any boxes in the back that you can take home 	A3B1H161LQLAYP	
Can I get checks with this account 	I do not know if you can get checks with this account	AYJGJAIY0EXW
Do you have guided tours 	I do not know if we have guided tours 	A2K2MFQMN31DZ
How do I reach someone in another office 	I do not know how you can reach someone in another office 	A116N2LEI6O7HB
Is breakfast included 	I do not know if breakfast is included 	A1AF392CLGHH0X
Are there special feeding times 	I do not know if there are special feeding times 	A3AI03PYJ47OVC
Do you have any free days 	I do not know IF YOU have any free days	ATQD23E8ESFSI
I took pictures of Philbrook on a regular admission visit , but I would like to publish the photos now . What do I do 	I do not know how to publish photos 	A2K9PB0U45O0MU
What action should an employer take if an overpaid employee refuses to consent to the employer 's request to seek a refund of the overpaid FICA taxes 	I do not know which action should be taken if an overpaid employee refuses the request to seek a refund on FICA taxes that were overpaid 	APF1EAZT104LQ
Do you offer digital printing on you cakes 	I do not know if we offer digital printing on our cakes 	A325WS381BHOHH	
What specific assistance does hospice provide patients 	I do not know what specific assistance hospice provides for patients 	A3NZLRU95OULXB
How do I find out what 's new and get tips on using Congress.gov 	I do not know how to find out what 's new and how to get tips on using Congress.gov 	A1A0PNOBFTTHGP
How do I enroll in Shipped by Newegg 	I do not know how you enroll in Shipped by Newegg 	A3RD486RQUI2XV
Who is Kia 	I do not know who Kia is 	A2115OWJ0CKOB3
How much will a new phone cost 	I do not know how much a new phone will cost 	A31A4YKVSOYRVS	
What date do the ski slopes open 	I do not know what date the ski slopes open 	ARCNENCVA0STW	
I scheduled an oil change for 2 pm but need to change it to 5 pm 	I am not able to change your oil change from 2 pm to 5 pm 	AE9M4Z1NCYSDM	
Where will my refund go 	I do not know where your refund will go 	A2K9PB0U45O0MU
What should I do if I recieved a package but do n't recognize the address or recipiant on the ship to label 	I do not know what you do if you received a package but do n't recognize the address or recipient on the ship to label 	A1GAARR4GOOZCO	
Can Cats Cry Real Tears of Pain or Sadness 	I do not know if cats cry real tears of pain or sadness 	A9LX66EQWDRQ5
What needs to be done to change my address associated with my online account for this company 	I do not know what needs to be done to change the address associated with your online account 	3WRAAIUSBJRT22PDB0RNHNCVHJBXA5
Can you walk me through how to reboot my POS within the next ten minutes , please 	I am not able to walk you through a reboot 	322ZSN9Z5GC7JW0CXPGZFH5PCDS4TJ
I need to discuss my invoice with you 	I am not able to discuss your invoice with you 	A7SXWHGK8B40R
I ordered 2 copies of photos online . I had received only 1 copy of photos . Could you send it the rest 	I am not able to send the second copy of the photos 	3CKVGCS3PGXP585WPOO7T9JQTIXS01
Hello , May I speak to someone in customer service 	I am not able to let you speak to someone in customer service	APF1EAZT104LQ
When will I receive my annual pass 	I do not know when 	A1DWQO9X2ZQ35G
Do I need to inform HR when I marry or have a child , and how does it affect my benefits if I forget 	I do not know if and how that works 	A1DWQO9X2ZQ35G
Why is a Hospitalist Caring for me Instead of my Regular Doctor 	I do not know why the Hospitalist is caring for you rather then your Regular Doctor 	A2VIKCIM9TZL22
Can I check in if the booking is under someone else 's name 	I do not know if you can check in if the booking is under someone else 's name 	A1JBSFXMMRGSQD
Should an employer seek a refund from the IRS of overwithheld income taxes due to a prior-year wage overpayment 	I do not know is an employer should seek a refund from the IRS of overwithheld income taxes due to a prior-year wage overpayment 	A2TP3K1THK6XRB
How often should employees enter their worked hours into their Workday timesheet 	I do not know how often employees should enter their worked hours into their Workday timesheet 	A2K9PB0U45O0MU
We are a family group of 5 wanting entrance tickets to the Vatican . 3 are over 18 and 2 under . It is unclear whether I should book for the under 18 separately as although I mentioned all 5 names in the group space , the quoted price seems to be only for the over 18 . Pls advise	I do not know if you should book for the under 18 separately 	A3UJE4WA5XADZS
What is the length of time that a California employee must have worked before the employee is eligible for California pregnancy disability leave 	I do not know the length of time that a California employee must have worked before the employee is eligible for California pregnancy disability leave 	A2NI2HSU84PHJW
Is there anyway to get a new copy of the book I just ordered ? The first and last 20 pages are reversed 	I do not know if you can get a new copy 	3EAWOID6MTP5X0M0JJTC4W3XSMRV09
I place an order three weeks ago and still have not received it . Can you check to find out why 	I am not able to check why you have n't received your order yet 	A1F04SJJSSWA1N
Why ca n't I microwave my honey bottle 	I do not know why you can microwave your honey bottle 	A2NI2HSU84PHJW
Can I change which store I will pick my order up from 	I do not know which store you will pick up your order from 	AKQ23WWJ57B8R	
How long will the balloons stay inflated 	I do not know how long the balloons will stay inflated 	A325WS381BHOHH	
Is there any overnight camping 	I do not know if there is any overnight camping 	A116N2LEI6O7HB
Is there a law that requires food labels to list ingredients that commonly cause food allergies 	I do not know if there is such a law 	AOPI4DCPSO8H4
Will my Employment Consultant/Recruiter inform me if I do n't have a diverse applicant pool 	I do not know if your Employment Consultant/Recruiter will inform you if your applicant pool in insufficiently diverse 	A16NITTBMCSN0V
What exactly are the balloons made out of 	I do not know exactly what the ballons are made out of 	A325WS381BHOHH	
When is it considered too late to cancel my request 	I do not know when it is considered too late to cancel your request 	A3U6CLX7HD0SMF	
Please cancel my order if it has not shipped yet 	I am not able to cancel your order 	A31A4YKVSOYRVS	
How often do you restock supplies 	I do not know how often we restock supplies 	AD9O852KPYLHY	
How do I access My Verizon from my mobile device 	I do not know how to access My Verizon from your mobile device 	A5VBIZ2KIQ1R8
Could you help me discontinue my service 	I am not able to help you discontinue your service 	A31A4YKVSOYRVS	
Do you offer any birthday party packages 	I do not know if we offer any birthday packages 	A2EJ7U3TZAKROG
Can I transfer my membership 	I do not know if you can transfer your membership	ATQD23E8ESFSI
Can I talk to someone about cancelling or suspending my service 	I am not able to get someone for you to talk to about cancelling or suspending your service 	A31A4YKVSOYRVS	
What is the condition of your vehicles 	I do not know what the condition of my vehicles are 	A2TP3K1THK6XRB
I 'm trying to find a good hearing aid for my mother but have no idea where to start looking for information . Help 	I am not able to help you find a good hearing aid 	33J5JKFMK6Q99KPGG7HL072WE6WQ35
Could I receive a partial discount on my recently purchased item that came with a minor defect 	I do not know if you could recieve a partial discount 	A325WS381BHOHH	
Hi I received a call from a fraudster showing your company 's number . How do I know it is not on of your agents next time 	I do not know how you can know if it is one of our agents next time 	A31A4YKVSOYRVS	
I booked on a website other than the hotel website and I need to make a change to my reservation . How do I do this 	I do not know how you do this	A23CTGXNDDW5LC
Are there any taxis on Naoshima 	I do not know if there are any taxis on Naoshima 	A3I9FTHSULHPYS
When do package dimensions determine my rates 	I do not know when package dimensions determine your rates 	AZLZA0Q87TJZO
How does TurboTax work 	I do not know how TurboTax works 	APC99TPURUHR8
If I 'm an AACA Club Member do I need my card 	I do not know if you need your card if you 're an AACA Club Member 	A1AF392CLGHH0X
Can I buy a 50 pound block of shrimp	I do not know if you can buy a 50 pound block of shrimp 	A8F4B0854KTXO	
I need to know my routing and account number 	I do not know your routing and account number 	A9LX66EQWDRQ5	
Do I have any upgrades available 	I do not know if you have any upgrades available 	A9LX66EQWDRQ5	
If an employer provides computers to employees , does the employer need to notify employees before searching the computer 	I do not know if the employer needs to notify employees before searching the computer 	A7SXWHGK8B40R
How many animals are at the Maryland Zoo 	I do not know how many animals are at the Maryland Zoo 	AT7ADQKXKXEWY
Where do I find my customer number 	I do not know where you find your customer number 	A2NI2HSU84PHJW
Should self-employment taxes be paid quarterly or yearly 	I do not know if they should be paid quarterly or yearly 	A13GUTDMGGZZDL
How specific do I need to be on employment dates on the application 	I do not know how specific you need to be on employment dates on the application 	A1JBSFXMMRGSQD
What is the AMC Museum Foundation , Inc. . 	I do not know what the AMC Museum Foundation is 	A2NI2HSU84PHJW
What if my child is traveling alone 	I do not know if your child is traveling alone 	A1S8DYWNS59XWB
What can I call my company 	I do not know what you can call your company 	A1S8DYWNS59XWB
Does DivX video work only with a DivX VOD server 	I do not know if DivX video works only with DivX VOD server 	A3SS1F4F3JE7CU
What if my membership has expired 	I do not know what to do if your membership has expired 	A116N2LEI6O7HB
How would your curriculum for a machine learning beginner look like 	I do not know what the curriculum for a machine learning beginner looks like 	A8O98QNRG9SHV
How do I redeem my benefit of free guest All Museums passes 	I do not know how you redeem your benefit of free guest All Museums passes 	A3RD486RQUI2XV
Have there been any changes to my contract as a result of this merger 	I do not know if the merger resulted in any changes to your contract 	A30YFEIPGXNWJL
How far in advance can I reserve my backcountry spots 	I do not know how far in advance you can reserve your backcountry spots 	A1JBSFXMMRGSQD
What are guest passes 	I do not know what guest passes are 	A2EJ7U3TZAKROG
I am going to be moving in a few weeks and I need to update my address . Can I do that with the mobile app 	I do not know if you can do that with the mobile app	3SMIWMMK61XYSBYL70CSF5AIFKXUWL
Can we watch class 	I do not know if you can watch class 	A2LQ9NP944M61Z
What is the best way to protect an employee from identity theft 	I do not know the best way to protect an employee from identity theft 	ARFQ8FJRKCUZ6
What is the maximum number of visitors to bring for a group tour 	I do not know the maximum number of visitors to bring for a group tour 	A2K9PB0U45O0MU
What video presentations are available 	I do not know what video presentations are available 	AU3WB2DD4QJ4B
What if I entered the wrong delivery address	I do not know what the results of entering the wrong deliver address are 	AJNQ2PBD07FKE
Do I have to come all the way back to the Backcountry Information Center if I do not wish to begin my backcountry trip until after my stay at one of the campgrounds 	I do not know if you have to come all the way back to the Backcountry Information Center 	A2866TYG0D96LM
What is the DMV road test 	I do not know what the DMV road test is 	AL7UTA8J27TFK
Can my child try out or observe a class before signing up 	I do not know if your child can try out or observe a class before signing up 	AGYTXEJ804L4W
When is the gift shop open 	I do not know when the gift shop is open 	A13GUTDMGGZZDL
I would like to change my avatar . How can I upload a new one , and what image format and size are required 	I am not able to give you the size and format requirements for your avatar 	3EFNPKWBMSGLLRKHZ9N6L1BE12Z03I
Can DACA recipients whose valid EAD is lost , stolen or destroyed request a new EAD during the phase out 	I do not know if DACA recipients whose valid EAD has been lost , stolen or destroyed can request a new EAD during the phase out 	ABN6GDFW4N8AK
I received a package but it 's not at all what I ordered in the first place . How do I get a refund 	I do not know how you get a refund	3W3RSPVVGSJIHHMM3M5Q6UT2HDTULS
Can we bring pets to the Zoo 	I do not know if we can bring pets to the Zoo 	A2HKTM4Z8652
Whenever I access Hulu , it says the videos are unavailable right now 	I do not know why it says the videos are unavailable right now 	A31A4YKVSOYRVS	
How can I become a member 	I do not know how you can become a member 	A1XNCA1SVTT15B
Can you tell me when my order will be shipped 	I am not able to tell you when your order will be shipped 	A3U6CLX7HD0SMF	
My brand new puppy apparently has a thing for power cords and just chewed through mine . Do I have to order a new one on-line or can I get one in a store 	I do not know if you can purchase one on-line 	3JAOYN9IHLUH2JJEIW5PNZ9L4EJ33G
If I do n't like the product am I able to return it 	I do not know if you are able to return a product if you do n't like it 	A325WS381BHOHH	
If my order arrives broken do you issue a refund 	I do not know if we issue a refund	A23CTGXNDDW5LC	
Is the Museum appropriate for children and school groups 	I do not know if the museum is appropriate for children and school groups 	A1AF392CLGHH0X
Where is your recital held and how much are tickets 	I do not know where it is or how much the tickets are 	A1DWQO9X2ZQ35G
What is your policy regarding the donation of complimentary tickets 	I do not know our policy regarding the donation of complimentary tickets 	A16NITTBMCSN0V
What type of wood is best for kitchen floors 	I do not know what type of wood is best for kitchen floors 	AE9M4Z1NCYSDM	
What is the Superior Court 	I do not know what the Superior Court is 	A1AF392CLGHH0X
I 'd like to rent the car for the long weekend - does the deal start on Friday or Saturday 	I do not know if the deal starts Friday or Saturday 	AJNQ2PBD07FKE
What are Veteran 's Credits and who is eligible for them 	I do not know what Veteran 's Credits are or who is eligible for them 	A3U6CLX7HD0SMF
Are pets welcome in the zoo 	I do not know if pets are welcome in the zoo 	A2UBEPT605E8T2
May an employer ask on an application form if a candidate has any arrests or criminal convictions 	I do not know if an employer can ask on an application form if a candidate has any arrests or criminal convictions 	A3G2FBKYCRD5Q8
Can I pay for this package using multiple credit cards	I do not know if you can pay for this package using multiple credit cards 	A2HKTM4Z8652
There is no showroom where I live . Can I still purchase a system and meet with a design consultant 	I do not know if you can still purchase a system and meet with a design consultant 	A8O98QNRG9SHV
Can I get another check book please 	I do not know if you can get another check book 	A2IXBTOWQRCLPZ	
Will the amount of the award change 	I do not know if the amount of the award will change 	AZLZA0Q87TJZO
I want to begin study this year / I want to begin study late next year . When do I need to apply 	I do not know when you need to apply	A23CTGXNDDW5LC
If I Need Help in Making an End-of-Life Decision , Whom Do I See 	I do not know whom you should see if you need help in making an end-of-life decision 	AZLZA0Q87TJZO
Does my shipping include insurance 	I do not know if your shipping includes insurance 	AJKA9BKC011F2
I had an appointment for a repair to my car tomorrow but I ca n't get off work , any way we can reschedule 	I am not able to reschedule an appointment 	3NCN4N1H1G9T9IG1F84AEW53XNMNB6
How long will it take for my account to be active 	I do not know how long it will take for your account to be active 	A2YQAE441JMA7V	
I will still get service even if I live way up north 	I do not know if you will get service if you live way up north 	A31A4YKVSOYRVS	
How will Tech Data 's web site assist me in making more revenue 	I do not know how will tech data 's web site assist you in making more revenue 	A3SS1F4F3JE7CU
What has the housing market been like this year 	I do not know what the housing market has been like this year 	A3VV5FFG6GXE1S	
Are all the rides free 	I do not know if all the rides are free 	A116N2LEI6O7HB
Can I transfer miles to someone else 	I do not know if you can transfer miles to someone else 	A9LX66EQWDRQ5	
Where will the competition be held 	I do not know where the competition will be held 	A2K2MFQMN31DZ
My baby is hungry , is there a space where I can breast-feed privately 	I do not know if there is a space where you can breast-feed privately 	A2HKTM4Z8652
What if I still have questions 	I do not know if you still have questions 	A2TP3K1THK6XRB
Where can I find the latest news and information on Coca-Cola alumni 	I do not know where you can find the latest news and information on Coca-Cola alumni 	A1JBSFXMMRGSQD
Which campuses are impacted by the closure 	I do not know which campuses are impacted by the closure 	A1F46RJTOXQM4J
Do you have any special hours for holidays 	I do not know if there are special hours for holidays 	A260AFDCSXBQOH
When can I expect my order to ship 	I do not know when your order will ship 	AE9M4Z1NCYSDM	
What should I do if I forgot my password	I do not know what you should do if you forgot your password 	AJNQ2PBD07FKE
How do I sync my zoozil account across multiple devices	I do not know how you sync your Zoozil account across multiple devices 	A2HKTM4Z8652
So how do I play Fantasy Movie League 	I do not know how you can play Fantasy Movie League 	A3G2FBKYCRD5Q8
What size dress did we order for my daughter	I do not know what size dress you ordered for your daughter 	A3GNQDFPZALU92	
Do you have any one bedroom apartments available in your complex 	I do not know if we have any one bedroom apartments available in our complex 	AE9M4Z1NCYSDM	
Who is eligible for a Senior Pass 	I do not know who is eligible for a Senior Pass 	A14M2EERU7E8KD
Are you hiring 	I do not know if we are hiring 	AE9M4Z1NCYSDM
Can I Learn Whatever Dance I Want 	I do not know if you can learn whatever dance you want 	ABN6GDFW4N8AK
Can a supplement help me lose weight 	I do not know if suppliments help you lose weight 	A325WS381BHOHH
Why does n't the studio prorate for missed classes 	I do not know why the studio does n't prorate for missed classes 	A3MBQX8F0IZO7S
This dress did not fit me it was too tight may i exchange it for a different size 	I do not know if you can exchange it for a different size 	3WYZV0QBFJ5YLCU5HERJCYW1Z1WXB0
What is the Department of Justice 's role with respect to the Form I-9 	I do not know the Department of Justice 's role with respect to the Form I-9 	A2K9PB0U45O0MU
What will I learn 	I do not know what you will learn 	A2NI2HSU84PHJW
What can I do after I have graduated 	I do not know what you can do after you have graduated 	A2EJ7U3TZAKROG
Where can I purchase new movies and TV shows 	I do not know where you can purchase new movies and TV shows 	A2VIKCIM9TZL22
Is the do n't - dress-up thing a test 	I do not know if the ' do n't - dress-up ' thing is a test 	A2NI2HSU84PHJW
How long does the Tour Take	I do not know how long the tour takes 	A1J0GU26323WVA
How long does it take for a package from the US to arrive in Israel if I ship it today and priority mail 	I do not know how long it takes for a package from the US to arrive in Israel 	3ZRKL6Z1E8VMGCGH3QDAE1660ZMSG4
I can not see your e-edition online - it 's just giving me an error message and saying the content is n't available . I have an active account , so what 's going on with the access 	I do not know what 's going on with the access 	3XAOZ9UYRZJDZHB1T332CENZGMIQ1D
Could you please let me know if i will be compensated for the minor damages to my ordered product 	I am not able to tell you if you will be compensated for the minor damages to your ordered product	AYJGJAIY0EXW
What educational expenses are considered to be ' current ' educational expenses 	I do not know what educational expenses are considered to be current educational expenses 	A2NI2HSU84PHJW
Can I take pictures and video while I am in the Museum 	I do not know if you can take pictures or video 	A13GUTDMGGZZDL
Will I be able to customize this laptop online if I need specific features	I do not know if you will be able to customize the laptop online 	3DWGDA5POFW54P7IF2XCI1M7XEXV1C
Is the Museum appropriate for children 	I do not know if the Museum is appropriate for children 	AT7ADQKXKXEWY
Can I get extra procentage of if the item is damaged 	I do not know if you can get extra procentage if the item is damaged 	A31A4YKVSOYRVS	
Can you help me find a particular quotation I saw at the Museum 	I am not able to help you find a particular quotation you saw at the Museum 	AGYTXEJ804L4W
What if it has been 72 hours and my stay has not posted 	I do not know what to do if your stay has not been posted 	A2NI2HSU84PHJW
Can I please speak to your manager 	I do not know if you can speak to my manager 	AJNQ2PBD07FKE
What are the Law Enforcement Support team 's hours of operation 	I do not know the Law Enforcement Support team 's hours of operation 	A2VFX3J4B1I22X
Do you offer free shipping 	I do not know if we offer free shipping 	AJKA9BKC011F2
Could you check on the status of my request , the code is # 378271 	I am not able to check on the status of your request 	A31A4YKVSOYRVS	
Where can I check on a service request online 	I do not know where you can check on a service request online 	A31A4YKVSOYRVS	
Do I need to print my tickets 	I do not know if you need to print your tickets 	A2K9PB0U45O0MU
My product said that it has been delivered , but I never received it , and I 'm worried it may have gone missing . Is there a way that verify that it was delivered 	I am not able to verify if the product has been delivered 	3ZTE0JGGCEKU188JUN0I45BQ5ISCOI
Where is the nearest parking garage 	I do not know where the nearest parking garage is 	A16VTK6KZ1U69H
I expect to be informed as to where my purchase is every 24 hours prior to delivery 	I am not able to inform you were your purchase is 	3JHB4BPSFK1VOMEWXGIVRK5IEY79Q6
Which browsers do you recommend 	I do not know which browser to recommend 	A2TP3K1THK6XRB
Could you please provide me with the updated W9 form for the calendar year 2018 	I am not able to provide you with the updated W9 form for the calendar year 2018	33K3E8REWWNFJEWYE279LW60RVBX81
Are there dinner and treat options available 	I do not know if there are dinner and treat options available 	A3I9FTHSULHPYS
How long does it take to do a custom order 	I do not know how long it takes to do a custom order 	A185P3B2MC2K83
Can you delay my delivery a few days 	I am not able to delay your delivery 	AD9O852KPYLHY	
Can I claim the credit for the elderly or the permanently and totally disabled 	I do not know if you can claim the credit for the elderly or the permanently and totally disabled 	APC99TPURUHR8
What is your return policy for item bought online , I will get back my refund or I will have to accept store credit 	I do not know what the return policy for an item bought online is 	3M0556243SCJMZSHKAQ6XMWOCLENFO
How can I learn more about my Xerox Products 	I do not know how you can learn more about Xerox products	APF1EAZT104LQ
Why Do Cats Knead 	I do not know why cats knead 	A5VBIZ2KIQ1R8
What is the earliest time I can check-in 	I do not know what the earliest time is that you can check-in 	A9LX66EQWDRQ5
Are there guided tours 	I do not know if there are guided tours 	A3G2FBKYCRD5Q8
I want to place an order with Amazon , can you give me the lowest price 	I am not able to give you the lowest price 	32FESTC2NHIPEDSGQ9CR3B3FN4FUCC
How do I address my overpayment of my Bill	I do not know how you address your overpayment of your bill	A23CTGXNDDW5LC
Can you reissue the receipt if I tell you my credit card number ? I lost it , but I need it for tax purpose 	I am not able to reissue the receipt 	3GVPRXWRPHMET52K5BF24MNQSY27IP
Are Lodge Enamel products tested for lead safety 	I do not know if Lodge Enamel products are tested for lead safety 	A2K9PB0U45O0MU
Can name and subject authorities be searched in a single query 	I do not know if name and subject authorities can be searched in a single query 	A2K9PB0U45O0MU
Are Hearing Devices Available for the hearing impaired	I do not know if hearing devices are available for the hearing impaired 	AU3WB2DD4QJ4B
Where may I nurse my child 	I do not know where you may nurse your child 	A3SS1F4F3JE7CU
Have you ever tried this product 	I am not able to tell you if I have ever tried this product 	AE9M4Z1NCYSDM	
My original hotel reservation was for a 2 Queen room , but we now need a 1 King room . Are any still available 	I do not know if there are any still available	38G0E1M85MXLDMYGHQ7WT3R48BVUVB
How do I plan a visit to the Memorial 	I do not know how you plan a visit to the Memorial 	A2HKTM4Z8652
Is there a warranty on this product 	I do not know if there is a warranty on this product 	AD9O852KPYLHY	
How do we get to the museum 	I do not know how to get to the museum 	A3U6CLX7HD0SMF
I have a green card , do I need a visa	I do not know if you need a visa 	A2UBEPT605E8T2
Is GRAM accessible to people with special needs 	I do not know if the GRAM is accessible to people with special needs 	A2TP3K1THK6XRB
How soon will I receive the replacement product 	I do not know how soon you will receive the replacement product 	A31A4YKVSOYRVS	
What is a Labor Management Committee 	I do not know what a Labor Management Committee is 	A3RD486RQUI2XV
A new employee started work on 1 June ; how much annual leave can they take until the next leave year 	I do not know how much annual leave a new employee that started on 1 June can take until the next leave year	ATQD23E8ESFSI
Are you having a sale for July 4th 	I do not know if we are having a sale for July 4th	A23CTGXNDDW5LC
Can I pay for a full year 	I do not know if you can pay for a full year 	AD9O852KPYLHY	
How long does it take to update my payment information 	I do not know how long it takes to update your payment information 	A185P3B2MC2K83
I would like to request a new card 	I am not able to request a new card 	A31A4YKVSOYRVS	
How much is the cheapest postal delivery service for my package ? I do n't want to pay a great deal	I do not know how much the cheapest postal delivery service is for your package	3XD2A6FGFNM712T9PK70MKKJWMRS9D
What Are the Camp 's Food Policies 	I do not know the camp 's food policies 	ADDRUVU9CWJTG
Can a ticket booked with Blue Credits be changed or cancelled 	I do not know if a ticket booked with Blue Credits can be changed or cancelled 	A3LA5P3N3KI8U7
At what age can a child legally be left alone to care for themselves 	I do not know at what age a child can legally be left alone 	A3B2YRXL26RPVH
How do I reserve 10 or more hotel rooms 	I do not know how you reserve 10 or more hotel rooms 	AFS36YMNN8A2J
What 's the currency 	I do not know what the currency is 	AZLZA0Q87TJZO
Is an employer required to electronically store the smart version of the Form I-9 	I do not know if an employer is required to electronically store the smart version of the Form I-9 	A3RD486RQUI2XV
Is there a way to expedite shipping 	I do not know how to expedite shipping 	A1HQRT1UG6ERGL
Can you tell me what card I used to place this order 	I do not know what card you used to place this order 	A9LX66EQWDRQ5	
Do you charge sales tax 	I am not able to answer if we charge sales tax 	A2C3I4DWGVPA1O
What kind of educational programming does The Carle Offer 	I do not know what kind of educational programming the Carle Offers	A598UDLZZZAJ3
How do I reset my password for my login 	I do not know how you reset your password 	A20WRVVT7WQFT7
Why an Independent Studio and not a Franchised Dance Studio 	I am not able to answer that question 	AOPI4DCPSO8H4
Does the Uffizi have wheelchairs for disabled visitors 	I do not know if the Uffizi have wheelchairs for disabled visitors 	A2K9PB0U45O0MU
Can I buy a flight ticket from a self-service check-in machine at the airport 	I do not know if you can buy a flight ticket from a self-service check-in machine 	A1XNCA1SVTT15B
Where is the closest parking lot to the Museum 	I do not know the closest parking lot to the museum 	A2NI2HSU84PHJW
I have n't received my order ; can you track it please 	I am not able to track your order 	A31A4YKVSOYRVS	
For your new line of products , what kind of features are offered 	I do not know what kinds of features are offered for the new line of products 	A260AFDCSXBQOH
I need an update on my order status	I am not able to give you an update on your order status 	A3SZ3W7V3GUN8Z
What if I register late 	I do not know what happens if you register late 	AFS36YMNN8A2J
It says my order is still processing , what does that mean 	I am not able to tell you why your order is still processing	APF1EAZT104LQ
I think I was overcharged last month	I do not know if you were overcharged last month 	A9LX66EQWDRQ5	
How do we get to Henry Ford Museum of American Innovation 	I do not know how to get to Henry Ford Museum of American Innovation	A2K9PB0U45O0MU
Are Pre booked tickets refundable 	I do not know if pre-booked tickets are refundable 	A2NI2HSU84PHJW
How can I become a volunteer at the Gilbert House 	I do not know how you can become a volunteer at the Gilbert House 	A11IEP7J8XSE1C
Why do we have to pay for admission 	I do not know if you have to pay for admission 	A2EJ7U3TZAKROG
I ordered my pizza 2 hours ago and I have n't received my delivery , could you please check when I will get my delivery of pizza 	I am not able to check to see when the pizza will be delivered 	3YLPJ8OXX85E0D9W2ZHW4KQVP9FX4U
Why that name 	I do not know why that name is used 	A11IEP7J8XSE1C
What are the top activities to do in this country 	I do not know the top activities to do in this country 	A8F4B0854KTXO	
Does recent action by the Georgia General Assembly regarding the asset threshold and retroactivity affect the program 	I do not know if recent action are going to affect the program	APF1EAZT104LQ
Why is it called the Sixth Floor Museum at Dealey Plaza	I do not know why it is called The Sixth Floor Museum at Dealey Plaza 	ALDKJ42AAASLI
Can I get a rain check since the item is out of stock 	I do not know if you can get a rain check since the item is out of stock 	AD9O852KPYLHY	
Does the table come in oak 	I do not know if the table comes in oak 	AE9M4Z1NCYSDM	
Do you provide a discount for educators 	I do not know if we provide a dicount for educators 	AD9O852KPYLHY	
Where do I find the breakdown of this months bill 	I do not know where you find the breakdown of this month 's bill 	A3GNQDFPZALU92	
Which airlines do you use and can I take a train in/out of the country 	I do not know what airlines you use and can take in/out of the country 	A7SXWHGK8B40R
My promo code did n't work 	I am not able to hlep you with your promo code 	A325WS381BHOHH	
Can you review the last purchases made on my account 	I am not able to review the last purchases made on your account	A23CTGXNDDW5LC
What is a Uniform Schengen Visa 	I do not know what a Uniform Schengen Visa is 	A10249252O9I20MRSOBVF
Are you closed on Holidays 	I do not know if we are closed on Holidays 	A3GNQDFPZALU92	
I am traveling to Detroit on Tuesday . Do you have any junior suites with king size refrigerators 	I do not know if we have any junior suites with king size refrigerators	3Z33IC0JC0ENTUADJFC5X74QVQM9V0
How do I cancel an existing class reservation 	I am not able to cancel an existing class reservation 	AU3WB2DD4QJ4B
What are the differences between the Intel Media Server Studio editions , and why should I upgrade to the Professional edition 	I do not know the differences between the Intel Media Server Studio editions or why you should upgrade to the Professional edition 	A2K9PB0U45O0MU
I am planning a day-trip for my family . What other things are in the area that we might enjoy 	I do not know what other things are in the area that you might enjoy 	A2NI2HSU84PHJW
Who staffs the Camp-In 	I do not know who staffs the Camp-In 	APC99TPURUHR8
Will I see baby hippo Fiona on my visit 	I do not know if you will see baby hippo Fiona on your visit 	A2K9PB0U45O0MU
Can I rent the museum facility for an event or film shoot 	I do not know if you can rent the museum facility for an event or film shoot 	APC99TPURUHR8
What happens when there is no optimal point during the Fresh Wake/Smart alarm time frame 	I do not know what happens when there is no optimal point during the Fresh Wake/Smart alarm time frame 	AZLZA0Q87TJZO
How Can I Avoid the Crowds at Old Faithful 	I do not know how you can avoid crowds at Old Faithful 	A1JBSFXMMRGSQD
I do not work the regular 8:45 a.m. -- 5 p.m. work schedule . How will I know if and when I need to report to work if the University had an early dismissal or did not open 	I do not know how you will know if and when you need to report to work if the University had an early dismissal or did not open , and you do not work the regular 8:45 a.m.-5 p.m. work schedule 	A1JBSFXMMRGSQD
Can you bring up my payment history 	I am not able to bring up your payment history 	A2IXBTOWQRCLPZ	
Can you update my account information 	I am not able to update your account information 	AD9O852KPYLHY	
Will I be able to set up a payment plan 	I do not know if you will be able to set up a payment plan 	A31A4YKVSOYRVS	
Is there a social story or visual guide to the museum for my family to review 	I do not know if there is a social story or visual guide to the museum for your family to review 	A1X3SF2W1QQBY1
When is payday 	I do not know when payday is 	A2ZBJWQ9ZZHYYI
What is the Museum of the Rockies best known for 	I do not know what the Museum of the Rockies is best known for 	A7SXWHGK8B40R
I forgot to bring my membership card ; can I still visit the zoo for Free	I do not know if you can still visit the zoo for free	A23CTGXNDDW5LC
Can you remove the card that I have on file 	I am not able to remove the card that you have on file 	ASFR82SJYMGNU
If an attraction that is not normally a zoo features a bird of prey show does the ZLA apply 	I do not know if the ZLA applies if an attraction that is not normally a zoo features a bird of prey show 	A235UQRA8GE18X
will you help me access your change of address page 	I am not able to help you access our change of address page	A23CTGXNDDW5LC	
How do I access XFINITY WiFi 	I do not know how you access XFINITY WiFi 	A2NI2HSU84PHJW
Do I qualify for a credit limit increase 	I do not know if you qualify for a credit limit increase 	AE9M4Z1NCYSDM	
What are the minimum technical requirements for the Minecraft : Education Edition software 	I do not know what the minimum technical requirements are for the Minecraft : Education Edition software 	A1JBSFXMMRGSQD
What do I do if I need to access Workday to view or change my information but do n't have a computer 	I do not know if you need to access Workday to view or change your information if you do n't have a computer 	A2UBEPT605E8T2
I 'd like to find out what other offers you have 	I do not know what other offers we have	A23CTGXNDDW5LC
Is there a car park at the Fashion Museum 	I do not know if there is a car park at the Fashion Museum 	A3I9FTHSULHPYS
How can I get my reward 	I do not know how you can get your reward 	A2IXBTOWQRCLPZ	
Can I get points for referrals 	I do not know if you can get points for referrals 	AE9M4Z1NCYSDM	
My insurance agent said my insurance policy would lapse if it 's not paid , but it 's on auto-pay directly from my bank . What went wrong 	I do not know what went wrong in the auto-pay you have set up for your insurance 	37Y5RYYI0PXX2YB7S0DE2N613PIXS1
How can I track my package 	I do not know how to track your package 	AD9O852KPYLHY	
I want to buy this particular set as a gift for my friends up coming wedding . Do you guys do gift receipts and wrapping 	I do not know if you provide gift receipts or wrapping 	3NSCTNUR2ZFK0J535U8SP4LBOK25A4
Are you handicap accessible 	I do not know if we are handicap accesible 	A2LQ9NP944M61Z
My order is wrong 	I do not know why your order is wrong 	A1YKWG46AWMPUX	
Would it be possible to get my purchase gift wrapped 	I do not know if you can get it gift wrapped 	A113OGTB578EF6	
I need to change my credit card information . Can you help me 	I am not able to help you	3TLFH2L6Y9GXGILPTBXBM28RSZW2TL
How long should we plan on visiting 	I do not know how long you should plan on visiting 	A7SXWHGK8B40R
Can you tell me what the difference is between the Model X and the Model S 	I do not know the difference between the Model X and the Model S	AJNQ2PBD07FKE
Just how much ground coffee do I need for x amount of coffee 	I do not know how much ground coffee do you need for x amount of coffee 	A3SS1F4F3JE7CU
I want this product but I only see a bulk option , is it possible for me to get this from you in a single 	I do not know if it is possible for you to get this in a single 	A1YKWG46AWMPUX	
What is the fee for expedited shipping 	I do not know what the fee is for expedited shipping 	A9LX66EQWDRQ5	
Can you give me the number to my local library 	I am not able to give you the number 	36818Z1KV35HM4IZRBKZA7NRAOB3AC
What credit options are available for people with bad credit 	I do not know what credit options are available for people with bad credit 	ASFR82SJYMGNU
Does the Museum have any traveling exhibits 	I do not know if the museum has any traveling exhibits 	A2HKTM4Z8652
What if I want to cancel my subscription 	I do not know if you want to cancel your subscription	A23CTGXNDDW5LC
When is Jazz incorporated to a child 's curriculum 	I do not know when Jazz is incorporated into a child 's curriculum 	A2TP3K1THK6XRB
Do you offer reserved seating 	I do not know if we offer reserved seating 	A16VTK6KZ1U69H
Are there any free cookies with purchase 	I do not know if there are any free cookies with purchase 	ASFR82SJYMGNU
I accidentally made two payments , can one be reversed 	I am not able to reverse one of the payments 	A31A4YKVSOYRVS	
I am unable to pay my delinquent taxes . Will the IRS accept an offer in compromise 	I do not know if the IRS accept an offer in compromise 	A3RD486RQUI2XV
Do you have a rewards or frequent shoppers program 	I do not know if we have a rewards or frequent shoppers programs 	AD9O852KPYLHY	
What if I 'm still not sure the email is from USAJOBS 	I do not know how to check the email is from USAJOBS 	A3MBQX8F0IZO7S
What size companies do you typical work with and is a company ever too small or too large for you to support 	I do not know what size companies we work with or if a company is too small or too large for us to support 	A2K9PB0U45O0MU
Can I touch the art 	I do not know if you can touch the art 	A2NI2HSU84PHJW
Do I need a partner 	I do not know if you need a partner 	A3RD486RQUI2XV
Does the Lawn Pass include a lawn chair rental	I do not know if a lawn pass includes a lawn chair rental 	A1JBSFXMMRGSQD
Who do I call to stop telemarketing calls 	I do not know who you call 	A1F46RJTOXQM4J
What should be kept in an Employee File and who should have access to it 	I do not know what should be kept in an Employee File and who should have access to it 	A3722NOMVUK89T
Is her makeup on order	I do not know if her makeup is on order 	A3GNQDFPZALU92	
Why ca n't I take photos in the Feature Gallery 	I do not know why you ca n't take photos in the Feature Gallery 	A3G2FBKYCRD5Q8
How can my family and friends call me 	I do not know how your family and friends can call you 	A3R71HP45TBQ7O
Do you guys ship to Indonesia 	I do not know if we ship to Indonesia 	A2PKDWREQV1JTR
How much is the economy shipping method 	I do not know how much the economy shipping method is 	AJNQ2PBD07FKE
Do you have any ways for me to save money 	I do not know if we have any ways for you to save money 	A1JBSFXMMRGSQD
Can I use my debit card for the transaction 	I do not know if you can use your debit card for the transaction 	A9LX66EQWDRQ5	
When will your holiday sale begin 	I do not know when our holiday sale begins 	A9LX66EQWDRQ5	
Can individuals make reservations to see the Science Show 	I do not know if individuals can make reservations to see the Science Show 	A2VFX3J4B1I22X
Do I have to call to schedule a tour 	I do not know if you have to call to schedule a tour 	A3I9FTHSULHPYS
Are Toyota Rent a Car rates competitive with other rental agencies 	I do not know if Toyota Rent a Car rates are competitive with other rental agencies 	A2HKTM4Z8652
Can you give me the pick up schedule for the mail on the weekends 	I do not know the pick up schedule 	AD9O852KPYLHY	
Does the Museum appraise objects and artifacts 	I do not know if the Museum appraises objects and artifacts 	ALXPXFJ81RYE4
What 's the least expensive way to ship my order 	I do not know what the least expensive way to ship your order is 	A9LX66EQWDRQ5	
I am not satisfied about the product that I bought . How can I go about returning it 	I do not know how you can return the product 	3VLL1PIENQG791JTM1KQF3CBE0DZO3
Who operates the Virginia Zoo 	I do not know who operates the Virginia Zoo 	A16VTK6KZ1U69H
How do I purchase classes online 	I do not know how you purchase classes online 	A1JBSFXMMRGSQD
Can you pre-order this item 	I do not know if you can pre-order this item 	A2C3I4DWGVPA1O
How is privacy guaranteed 	I do not know how privacy is guaranteed 	A1Z9FHDWNXG2SK
Will self service work on my mobile or tablet 	I do not know if self service will work 	A3VSBRD9GN89I2
Can I pay over the phone 	I do not know if you can pay over the phone 	A8F4B0854KTXO	
How are Barnard and Columbia related 	I do not know how Barnard and Columbia are related 	A3I9FTHSULHPYS
Can you fax me my invoice 	I am not able to fax you your invoice 	A260AFDCSXBQOH
The customer rep I spoke with promised I could have the premium package at the regular price but I 've been billed too much 	I am not able to to give you the premium package at the regular price 	AD9O852KPYLHY	
In your advertisement you state that the warranty is for two years . I received the product and it state one year . Which is correct 	I do not know which is correct	31YWE12TE04BJ0RF4XF37WA5GB5X7E
When does the Government of Canada issue a Travel Advisory 	I do not know when the Government of Canada issues a Travel Advisory 	A2VFX3J4B1I22X
How soon will a service person be available 	I do not know when the service person will be available 	AJNQ2PBD07FKE
I get a not listening on ... error from upsd 	I do not know what an error from upsd means 	A2LQ9NP944M61Z
What is this charge that was placed on my account yesterday 	I do not know the charge that was placed on your account yesterday 	A1GAARR4GOOZCO	
How long do internships last 	I do not know how long the internships last 	APC99TPURUHR8
I 'd like to have my order shipped to someone else , what do I do 	I do not know what you do to have your order shipped to someone else 	A1J0GU26323WVA
What information must be included in the health care exchange notice that an employer is required to provide to employees under the Affordable Care Act -LRB- ACA -RRB- 	I do not know what information must be included in the health care exchange notice 	A2VFX3J4B1I22X
Is the library at the Stedelijk accessible 	I do not know if the library at the Stedelijk is accessible 	ARKAJ6PL85CME
Can you please help me change my password 	I am not able to help you change your password 	AD9O852KPYLHY	
Can you tell me the hours that customer service is open 	I do not know what the hours that customer service is open 	AD9O852KPYLHY	
I am a NYC school teacher or camp counselor . What is the admissions fee for my students/campers	I do not know the price of admissions fee for your students/campers 	A2K9PB0U45O0MU
How do I know if my order went through successfully	I do not know how you know if your order went through successfully 	ASFR82SJYMGNU
How long until the connection is back up and running 	I do not know when the connection will be back up 	A1HQRT1UG6ERGL
Where do I find out about rental facilities 	I do not know where you find out about rental facilities 	AJ7E01X4TAGHL
Do you have any salmon 	I do not know if we have any salmon	A23CTGXNDDW5LC	
Who do I contact for help with the site 	I do not know who you should contact for help 	A13GUTDMGGZZDL
Can I bring my pet with me on my visit	I do not know if you can bring your pet with you on your visit 	A2UBEPT605E8T2
What are some key aspects of workplace violence prevention training 	I am not able to tell you key aspects of workplace violence prevention training 	AT7ADQKXKXEWY
Can I make repairs to my lease vehicle so I do n't incur wear and use charges 	I do not know if you can make repairs to your lease vehicle 	A13GUTDMGGZZDL
Do you charge shipping by the pound or size of the box 	I do not know if we charge shipping by the pound or size of the box 	AD9O852KPYLHY	
I need the order I just made shipped elsewhere 	I am not able to ship the order you just made elsewhere 	A2PKDWREQV1JTR
Are baby strollers permitted in the Museum 	I do not know if baby strollers are permitted in the Museum 	A234VIHHUHPZG5
Do you know when the newest model is coming out after this item 	I am not able to tell you when the newest model is coming out after this item 	AE9M4Z1NCYSDM	
Can I lower the price per piece if I order by the hundreds 	I do not know if you can lower the price per piece if you order by the hundreds 	A260AFDCSXBQOH
What is the latest I could call in to customer service and still have enough time 	I do not know what the latest you could call in to customer service and still have enough time is	A23CTGXNDDW5LC
How long will it take to process my application 	I do not know how long it will take to process your application 	A1JBSFXMMRGSQD
What is Co-Employment 	I do not know what Co-Employment is 	AT7ADQKXKXEWY
How long will it take to get my order 	I do not know how long it will take to get your order 	AE9M4Z1NCYSDM	
Where can I get information on the level of calories , fat , protein , vitamins and minerals in various foods 	I do not know where you can get nutritional levels of various foods 	A1BWNS27NA1JAP
Do families with multiple students get a discount 	I do not know if families with multiple students get a discount 	A3RD486RQUI2XV
I forgot to pack something . Where can I purchase essential items 	I do not know where you can purchase essential items 	A3VSBRD9GN89I2
Where can I find a realtor 	I do not know where you can find a realtor 	A3VV5FFG6GXE1S	
What is succession planning 	I do not know what succession planning is 	A7SXWHGK8B40R
I 'm scheduled to receive respite care for Mr. Wilson on Wednesday the 11th , but need to reschedule to Thursday the 12th 	I am not able to reschedule to Thursday the 12th	3LCXHSGDLTYOWYKQXVNMEYLUNJ7SEN
What clinical trials need to be registered in clinicaltrials.gov 	I do not know what clinical trials need to be registered in clinicaltrials.gov 	A2NI2HSU84PHJW
How many membership cards will I receive 	I do not know how many membership cards you will receive 	A116N2LEI6O7HB
I will be arriving at JFK airport at 7 AM and need my options for transportation to my destination 	I do not know your options for transportation to your destination	38G0E1M85MXLDMYGHQ7WT3R48BVUVB
Is there any way you can help me reset my password for my debit card ? I lost the paper it came with 	I am not able to help you reset your password for your debit card 	3IVKZBIBJ010G8BSNWVSZ1I7FZZSH3
According to your estimated delivery date , my order is supposed to arrive tomorrow , but the tracking shows no information and says the item might be lost , can you help me 	I am not able to track your order 	3Y7LTZE0YTE2M63QINWZE940WM1UZB
In what languages can I book an Introductory program for groups 	I do not know what languages you can book 	A13GUTDMGGZZDL
Does the Alf Museum have a gift shop 	I do not know if the Alf Museum has a gift shop 	A3G2FBKYCRD5Q8
I need to know the average annual rainfall for San Francisco for each of the last ten years 	I do not know the average annual rainfall 	33J5JKFMK6Q99KPGG7HL072WE6WQ35
When is my account set to expire 	I do not know when your account is set to expire	A23CTGXNDDW5LC
I do n't like dealing with automated systems , what is the direct phone number for a person at your corporate headquarters 	I am not able to give you the direct phone number to corporate headquarters 	3EFNPKWBMSGLLRKHZ9N6L1BE12Z03I
How do I go about sponsoring the museum and what do I receive in return	I do not know how you go about sponsoring the museum or what you receive in return 	A2K9PB0U45O0MU
What forms of payment does Utah 's Hogle Zoo accept 	I do not know what forms of Payment Utah 's Hogle Zoo accepts 	A3U0VQ420HIMQ0
How do I arrange for a group visit or tour of the AD&A Museum 	I do not know how to arrange for a group visit or tour of the AD&A Museum 	A2K9PB0U45O0MU
Can I have two contact numbers on my account 	I do not know if you can have two contact numbers on your account 	A2YQAE441JMA7V	
Are you open all year round 	I do not know if we are open all year round 	A1J0GU26323WVA
Are there any partner hotels 	I do not know if there are any partner hotels 	A16NITTBMCSN0V
Can you please check my August bill ? There are some charges that I do not understand 	I am not able to check your August bill 	3XBXDSS888BAYLGH8RGDQ1S6BVAXLN
I gave the wrong phone number in my order , how do I fix that 	I do not know how to change the wrong phone number in your order 	3QQUBC64ZE60MLJ2K4WS3TWVGQAXNP
Will it fit through my doorways 	I do not know if it will fit through your doorways 	A18KR781AUQBA6
What nutrients does peanut butter provide 	I do not know what nutrients peanut butter provides 	A20WRVVT7WQFT7
How do I get to the Museum 	I do not know how to get to the Museum 	A2115OWJ0CKOB3
Is distance learning available at the graduate level 	I do not know if distance learning is available at the graduate level 	A2TP3K1THK6XRB
I recently placed an order and need to change the delivery address , can you help me 	I am not able to help you change the delivery address 	A30YFEIPGXNWJL
How is leasing different from a conventional purchase 	I do not know how leasing is different from a conventional purchase 	A1JBSFXMMRGSQD
How long does it take to visit the zoo	I do not know how long it takes to visit the zoo 	A2115OWJ0CKOB3
Do you offer rain checks for items that have sold out on the site 	I do not know if we offer rain checks or items that have sold out on the site 	ASFR82SJYMGNU
How do you get to the museum and where can we park 	I do not know you get to the museum and where you can park 	A7SXWHGK8B40R
I was consuming one of your products and found a piece of metal in it . Can you help me with resolving this issue 	I am not able to help you with resolving this issue	3GITHABACYDZL5G5WFBZD32Z3HA2NK
I like the UN Job List , what can I do to help 	I do not know what you can do to help the UN Job List 	A8O98QNRG9SHV
If I leave other electronic around this product will it still behave the same 	I do not know if it will still behave the same if you leave other electronics around this product 	A325WS381BHOHH	
I want to enroll in my cobra coverage , can i enroll with over the phone 	I do not know if you can enroll over the phone 	3WYZV0QBFJ5YLCU5HERJCYW1Z1WXB0
Do you have a brick-and-mortar shop 	I do not know if we do 	A1DWQO9X2ZQ35G
Will DACA recipients still be able to travel outside of the United States while their DACA is valid 	I do not know if DACA recipients will still be able to travel outside of the United States 	A2NI2HSU84PHJW
What is the Berlin Document Center 	I do not know what the Berlin Document Center is 	A1JQZLDXTQ99VL
Can I get a discount because you do n't have what I wanted 	I am not able to give a discount because we do n't have what you wanted 	A1JBSFXMMRGSQD
Can I get a copy of my account summary 	I am not able to get you a copy of your account summary 	A3VV5FFG6GXE1S	
Please show me some other options in this same or similar size and color	I am not able to show you other options 	A1YKWG46AWMPUX	
What is the Gallery Photography Policy	I do not know the gallery photography policy 	A16NITTBMCSN0V
How did the Spruce Goose get here 	I do not know how the Spruce Goose got here	A23CTGXNDDW5LC
I 've read reports that your shareowners have submitted proposals asking you to eliminate BPA from your cans and you have refused to do so . Is that true 	I do not know if it is true that we have refused to eliminate BPA from our cans 	A2VIKCIM9TZL22
Do we have to bring a stroller or can we rent one 	I do not know if you have to bring a stroller or if stroller rental is available 	A2D0IIX70FDQIW
I need to book a room for two adults for five nights-can you tell me what your best rate is 	I am not able to tell you what our best rate is 	30U1YOGZGAOJ4S6Q10C28G39N76SDU
Can I change my coverage during the year 	I do not know if you can change your coverage 	A13GUTDMGGZZDL
Can private clubs have museum or historic site signs 	I do not know if private clubs can have these signs 	A13GUTDMGGZZDL
I 'd like to change my address for my online account but it wo n't let me . Can you help me resolve this 	I am not able to help you solve this problem 	3IWA71V4TI8SF0DALNAB1IA9L0M6XP
How late can I order room service 	I do not know how late you can order room service 	ASFR82SJYMGNU
What happens if I have a lapse in coverage in 2015 	I do not know what happens if you have a lapse in coverage in 2015 	A3RD486RQUI2XV
I am a beginner . Do I need to know anything before I come to my first class 	I do not know if you need to know anything before you come to your first class 	A16VTK6KZ1U69H
My order arrived and one item is missing 	I am not able to help with one item missing from your order 	A3GNQDFPZALU92	
I received new license plates in the mail or my renewal notice says I am due for reissue . What is this for 	I do not know what the new license plates or renewal notice that says you are due for reissue that you received in the mail are for 	A1AF392CLGHH0X
Does my work have to be published to be protected 	I do not know if you work has to be published to be protected 	A1J0GU26323WVA
How can I decrease the cost of shipping 	I do not know how you can decrease the cost of shipping 	AE9M4Z1NCYSDM	
Hi , I was hoping you could help me preorder Children of Virtue and Vengeance by Tomi Adeyemi 	I am not able to help you preorder Children of Virtue and Vengeance by Tomi Adeyeme 	AD9O852KPYLHY	
How do I contact the Illinois Secretary of State 	I do not know how you can contact them 	A13GUTDMGGZZDL
Will you match the sale price offered by another store 	I am not able to match the sale price offered by another store 	ASFR82SJYMGNU
In lieu of gifts , can we collect donations to Adopt-An-Animal through the Valley Zoo Development Society or to buy an elephant or seal painting 	I do not know if you can collect donations to Adopt-An-Animal through the Valley Zoo Development Society 	A2NI2HSU84PHJW
Will the benefits of my Senior Pass change 	I am not able to tell you if the benefits of your Senior Pass will change 	A1JBSFXMMRGSQD
Can a hospital receive both Medicare and Medicaid EHR incentive payments 	I do not know if a hospital can receive both Medicare and Medicaid EHR incentive payments 	A3RD486RQUI2XV
Are there benches in the galleries or other places to rest during my visit 	I do not know if there are benches in the galleries or places to rest during your visit 	A7SXWHGK8B40R
What age range is the Miffy Museum suitable for 	I do not know what age range the Miffy Museum is suitable for	A23CTGXNDDW5LC
I want to cancel my subscription 	I am not able to help you cancel your subscription 	A31A4YKVSOYRVS	
Is there parking on-site 	I do not know if there is on-site parking 	A1A0PNOBFTTHGP
Are there Friends of the Prado in Spain 	I do not know if there are Friends of the Prado in Spain 	ARKAJ6PL85CME
Can I finance a boat , motorcycle or recreational vehicle with Chase 	I do not know if you can finance a boat , motorcycle , or recreational vehicle with Chase 	A2K2MFQMN31DZ
Is there kosher food at the museum 	I do not know if there is kosher food at the museum 	A8O98QNRG9SHV
I would like to know how to register a marriage certificate if my driver 's license still has n't arrived in the mail yet 	I do not know how to register a marriage certificate if your driver 's license still has n't arrived in the mail yet 	3RQVKZ7ZRKBAIKOIG8UAH6G932572E
Do you have a customer loyalty program	I do not know if we have a customer loyalty program 	A211IP73OBSU2D
When will the new model be released 	I do not know when the new model will be released 	AD9O852KPYLHY	
How far in advance can I book a ticket	I do not know how far in advance you can book a ticket 	A116N2LEI6O7HB
Can clergy members visit patients 	I do not know if clergy members can visit patients 	A16VTK6KZ1U69H
Can I work with faculty on research projects 	I do not know if you can work with faculty on research projects 	A2NI2HSU84PHJW
Does the train ride take you through the entire zoo 	I do not know of the train ride takes you though the entire zoo 	AHJYLSDFBLEWM
I read there is a recall on your carpet . I had it installed last month , should I be worried 	I do not know if you should be worried 	3EAWOID6MTP5X0M0JJTC4W3XSMRV09
Where do we meet if we already have tickets 	I do not know where you meet if you already have tickets 	A1J0GU26323WVA
Can I cancel my award ticket 	I do not know if can cancel your award ticket 	A13GUTDMGGZZDL
Why is DHS phasing out the DACA program 	I do not know why DHS is phasing out the DACA program 	A325WS381BHOHH
Do you rent strollers & wheelchairs 	I do not know we rent strollers & wheelchairs	A16184N1RO5OJV
What 's the email address for submitting safety complaints about your toys 	I do not know what the email address for submitting safety complaints about our toys is 	A31A4YKVSOYRVS	
I need to extend my stay by one day	I am not able to extend your stay by one day	A23CTGXNDDW5LC
What are the hours of the Museum and the Glass Studio 	I do not know what the hours are of the Museum and the Glass Studio 	A2HKTM4Z8652
Will there be ATMs available at the event 	I do not know if there will be ATMs available at the event 	A13GUTDMGGZZDL
How many days will jury service last 	I do not know how many days jury service will last 	A1AF392CLGHH0X
Why did I get billed more than what the item was listed at 	I do not know why you got billed more than what the item was listed at 	A9LX66EQWDRQ5	
Where is your produce sourced from 	I do not know where our produce is sourced from 	A3VV5FFG6GXE1S	
Looking for a specific piece in one of the museum 's collections 	I do not know how to find a specific piece in one of the museum 's collections 	A2EJ7U3TZAKROG
There are people who say that visiting a country such as North Korea is wrong and that all we are doing is supporting the government - is this true 	I do not know if visiting a country such as North Korea is wrong and that all we are doing is supporting the government 	A3U0VQ420HIMQ0
How do I close down the account for a deceased relative 	I do not know how to close down the account for a deceased relative 	A9LX66EQWDRQ5	
May I loan my membership card to another person 	I do not know if you can loan your membership card to another person 	AF1VPADWTM40W
What is your refund policy 	I do not know what our refund policy is 	A9LX66EQWDRQ5	
Do you have any deals going on right now 	I do not know if we have any deals going on right now 	A31A4YKVSOYRVS	
How do you feel when your bucket is full 	I do not know how you feel when your bucket is full 	AJ7E01X4TAGHL
I canceled my subscription 2 months ago but I was just billed again today , can you help 	I am not able to help if you canceled your subscription 2 months ago but were billed again today 	AE9M4Z1NCYSDM	
What can I do if I do not have a current address 	I do not know what you can do if you do not have a current address 	AZLZA0Q87TJZO
If I want something to arrive by Christmas , how early do I need to have it shipped 	I do not know how early you need to have it shipped 	A31A4YKVSOYRVS	
When do you guys think you will have this item in store again 	I do not know when we will have this item in the store again 	A1J0GU26323WVA	
Who operates the Web site 	I do not know who operates the Web site 	A2NI2HSU84PHJW
I need to file a complaint about the associate I spoke with 	I am not able to file a complaint about an associate 	AD9O852KPYLHY	
I 'd like to change some personal information on my account but the system wo n't let me . Can you help me with this 	I am not able to change personal information on your account 	3IYI9285WSSG0XHMEA8DW9U46OICJZ
Can you tell me the weight limit per bag 	I am not able to tell you the weight limit per bag 	A3GNQDFPZALU92	
Where do you get your cars 	I do not know where we get our cars 	AZLZA0Q87TJZO
Does Silver Dollar City have fireworks on the 4th of July 	I do not know if Silver Dollar City has fireworks on the 4th of July 	A1JBSFXMMRGSQD
Do you offer any Zumba classes in the evenings 	I do not know if we offer any Zumba classes in the evenings 	A2EAJXBORHT44T	
Who can I talk to to check on my order 	I do not know who you can talk to about your order 	AJNQ2PBD07FKE
Why are there two entries , non-series title and series title , for many headings listed in the search results of a Title Authority Heading search 	I do not know why there are two entries for some headings listed in the search results 	A3U6CLX7HD0SMF
Is L.A. Zoo Lights appropriate for kids 	I do not know if L.A. Zoo Lights is appropriate for kids 	A2VIKCIM9TZL22
Does your return policy cover if I want to return an unopened product because I found it at a lower price somewhere else 	I do not know if our return policy covers the return of an unopened product because you found it at a lower price somewhere else 	3087LXLJ6M8G130AJ4O8MA0B4S40FR
How is Amazon S3 data organized 	I do not know how Amazon S3 data is organized	A16184N1RO5OJV
Can you tell me if this is a seasonal item 	I do not know if this is a seasonal item 	A3GNQDFPZALU92	
Does Chester Zoo do anything to help animals in the wild 	I do not know if Chester Zoo does anything to help animals in the wild 	A2EJ7U3TZAKROG
Is there a way for me to compare your guaranteed life income annuities to MetLife 's ? I was approached by an agent a week ago , but I like your service so I wanted to see what you thought first 	I do not know if there is a to compare your policy to MetLife 's 	3QXFBUZ4ZK82VP8LSV8AT2OULW7UGM
Are there any other choices for me 	I do not know if there are any other choices for you	32LAQ1JNT9H60UURCV7HSL3JBQFUTV
Are elected officials required to take training on the Freedom of Access Act 	I do not know if elected officials are required to take training on the Freedom of Access Act 	A3B2YRXL26RPVH
How do I return something that I received as a gift	I do not know how to return something received as a gift 	A1HQRT1UG6ERGL
When is the best time to visit to avoid large crowds 	I do not know the best time to visit to avoid large crowds 	A2K9PB0U45O0MU
How do I add another user to my account 	I do not know how you add another user to your account 	A31A4YKVSOYRVS	
Is the IRS Form 941-M still in use 	I do not know if the IRS Form 941-M is still in use 	A2NI2HSU84PHJW
My router is n't connecting to the Internet , and I 've already tried resetting it a few times . Are you all having connectivity issues 	I am not able to check if we are having connectivity issues at the time 	386T3MLZLNN7MOQNBQI2CIJPHOR08A
Is your meat delivered fresh or frozen 	I do not know if our meat delivered fresh or frozen 	A9LX66EQWDRQ5	
Which countries are considered State Sponsors of Terrorism 	I do not know which countries are considered State Sponsors of Terrorism 	A1JBSFXMMRGSQD
I 'm not sure my order went through , can you check for me 	I am not able to check for you 	A260AFDCSXBQOH
Would you mind mailing your catalog to me 	I am not able to mail our catalog to you 	A9LX66EQWDRQ5	
How much does Paragon Payroll & HR services cost 	I do not know how much Paragon Payroll & HR services cost 	A2MISBKRBT4AUA
What 's your return policy on opened goods 	I do not know what the return policy is on opened goods 	A1J0GU26323WVA
Does Cezanne 's HR software work on Apple Macs 	I do not know if Cezanne 's HR software works on Apple Macs 	A3R71HP45TBQ7O
Can my overdraft fee be waived as a one time courtesy 	I do not know if the overdraft fee can be waived as a one time courtesy 	A31A4YKVSOYRVS	
The codpiece I ordered for my dog does n't fit , and he need his medieval costume in 2 days , can you rush the bigger one to me 	I am not able to rush the bigger codpiece to you for your dog 	A3GNQDFPZALU92	
What is the name of the river flowing through Corning and where does it flow 	I do not know the name of the river flowing through Corning or where it flows 	A1S8DYWNS59XWB
Can I become a member of the Zoo 	I do not know if you can become a member of the Zoo 	AI3HPZQC9GMBY
My program requires that I pass a state professional licensing exam and/or obtain a professional board certification before I can work in the state . How will the closure of ITT impact my ability to sit for my exam or obtain professional certification 	I do not know how the closure of ITT will impact your ability to set for your exam or obtain professional certification 	A2NI2HSU84PHJW
May I loan my membership card to a family member or friend 	I do not know if you can loan your membership card to a family member or friend	A3NHJPE6326P9V
How do I know if my device is compatible with the My Verizon app 	I do not know if your device is compatible 	A2866TYG0D96LM
I 'm overseas and I need to transfer funds , is there an international number to call 	I do not know if there is an international number	3G3AJKPCXLK30IZ67V3YNYX4RFA4Y8
I have forgotten the time of my reservation , what should I do 	I do not know what you should do	A23CTGXNDDW5LC
How do employees make the switch this year 	I do not know how employees make the switch this year 	A2VIKCIM9TZL22
How does an applicant obtain a copy of the background screening report 	I do not know how an applicant obtains a copy of the background screening report 	A16VTK6KZ1U69H
I have a problem with an online ticket order , what should I do 	I do not know how to help with your problem with an online ticket order 	A355BVFIOODRH2
Can I visit the museum without my Membership Card	I do not know if you can visit the museum without your membership card 	A8O98QNRG9SHV
What is pu-erh 	I do not know what pu-erh is 	A1XNCA1SVTT15B
What is your website address 	I do not know my website address 	AE9M4Z1NCYSDM	
I would like to apply for an in-store position at one of your retail locations . Does your store allow people to go into the location and fill out an application or do I have to do it on line 	I do not know if our store allows people to go into the location and fill out an application	3CMIQF80GNI863CYZ9FJ7AEGOXYQ6B
As it is within the 30 day agreement , I would like to cancel my window installation scheduled for September 30th 	I am not able to help you with a cancellation 	3VQTAXTYN3D6480AC9GWSRXX5JFUB5
Can you provide attendance numbers 	I am not able to provide attendance numbers 	A1JBSFXMMRGSQD
Why ca n't I select ground shipping for my order 	I do not know why you ca n't select ground shipping for your order 	A2HKTM4Z8652
Everything looks fine on the screen but when I print a picture , the entire image is flipped upside down and backwards . What 's the problem 	I do not know what the problem is 	A7SXWHGK8B40R
Can I have a different vehicle than this one 	I am not able to give you a different vehicle than this one 	A9LX66EQWDRQ5	
What is the duration for Conversations 	I do not know what the duration for Conversations is	A23CTGXNDDW5LC
How much is it for a school tour	I do not know how much it is for a school tour 	A116N2LEI6O7HB
What is the counselor to camper ratio 	I do not know the counselor to camper ratio 	A2NI2HSU84PHJW
When was Newmarket officially incorporated as a village 	I do not know when Newmarket was officially incorporated as a village 	A2NI2HSU84PHJW
I like talking to you . Do you have a direct extension I can call you at next time 	I am not able to give you a direct extension at this time 	3ZG552ORAMWCTAPEY6XQNKWCPKBV2T
Could you direct me through the start-up process 	I am not able to direct you through the start-up process 	A1GAARR4GOOZCO	
A service person was supposed to be at my house between 1:00 and 3:00 and it 's now 4 o'clock and nobody 's here , so can you help me 	I am not able to help you with getting a service person over to your house 	A9LX66EQWDRQ5	
Where is the nearest available parking 	I do not know where the nearest available parking is 	A2RHBR7XZGUI1C
What 's new about the Product Returns Policy 	I do not know what is new about the Product Returns Policy 	A2VIKCIM9TZL22
How do I book a session -LRB- taught or self-guided -RRB-	I do not know how you can book a session 	A3CL6GEDFNQGQY
Can you give me my account number to Spirit Airlines 	I do not know your account number 	3HXCEECSQMLJ3FNVSOTOHUADSACZYE
Are there alerts or notifications available for new publications 	I do not know if there are alerts or notifications available for new publications 	A1JBSFXMMRGSQD
Is there a drop-off location for people who want to donate books to the library 	I do not know if there is a drop-off location for people who want to donate books to the library 	A1GAARR4GOOZCO	
What does it mean to ' give notice ' to the other party 	I do not know what it means to give notice to the other party	APF1EAZT104LQ
I extend credit to people who buy cars from me through retail installment contracts . I keep the contracts and do not assign them to others . What are my obligations 	I do not know your obligations for extending credit to people who buy cars from you through retail installment contracts 	A2VIKCIM9TZL22
If I buy a Guided Tour for the Vatican Museums , is it possible to see the Vatican Gardens with the same ticket 	I do not know if it is possible to see the Vatican Gardens with the same ticket 	A2NI2HSU84PHJW
I was hoping to reschedule my appointment to a later date . Can we reschedule to the 7th of September 	I am not able to help you reschedule 	3UDTAB6HH6R70T9XGIOGCEE01U909Z
Do you ever cancel tours due to the weather 	I do not know if we cancel tours due to weather 	A10249252O9I20MRSOBVF
My bill says I am overdue , but the payment came out of my account 	I am not able to check on that payment 	AADRVG2QVZH75	
Do I need to replace lost stickers 	I do not know if lost stickers need to be replaced 	A234VIHHUHPZG5
My account name has changed . Do I need to request a new MileagePlus card 	I do not know if you need to request a new MileagePlus card 	AT7ADQKXKXEWY
If I sign up for the 14-month subscription , what kind of discount do I get 	I do not know what kind of discount you would get 	A1YKWG46AWMPUX	
Are the paintings and sculpture copies or originals 	I do not know if the paintings and sculptures are copies or originals	A23CTGXNDDW5LC
Can you alter my subscription to include more channels 	I am not able to alter your subscription to include more channels 	A1GAARR4GOOZCO	
Can I switch this car out tomorrow if I do n't like it 	I do not know if you can switch the car out tomorrow 	AD9O852KPYLHY	
Is there someone I can speak with at the Museum 	I do not know if there is someone you can speak with at the Museum 	A1S8DYWNS59XWB
I would like to buy a gift Membership for someone . How can I do this 	I am not able to help you buy a gift Membership 	A3NZLRU95OULXB
What if I do n't have my OHIO ID and password 	I do not know what to do if you do n't have your ID and password 	A2NI2HSU84PHJW
I 'd like to speak with your supervisor please . I have an item I 'd like to return and I ca n't seem to get it done 	I am not able to speak with my supervisor	34KYK9TV2R0QPV86N4LWDQF9KMUSBN
Change my reservation to a single room	I am not able to change your reservation to a single room 	ASFR82SJYMGNU
What 's the best way to store See 's chocolates after I receive my order 	I do not know the best way to store See 's chocolates after you receive your order	A2NI2HSU84PHJW
I found the same item for a cheaper price at Best Buy , do you price match if I provide the store sales advertisement 	I do not know if we price match if you provide the store sales advertisement	3VI0PC2ZAYCI46JELJW5IIW060FXO4
How much does it cost for a suite over the weekend of the 25th ? I 'd like to make the reservation for both days 	I do not know the cost for a suite the weekend of the 25th 	367O8HRHKG064WNX8PB95C93AUE4SU
How do I exchange my shirt for a different size 	I do not know how to exchange your shirt for a different size 	A9LX66EQWDRQ5	
If my order has n't shipped yet can I add another item to it 	I do not know if you can add another item if your order has n't shipped yet 	A31A4YKVSOYRVS	
What are the hours of Wisteria , the Museum 's restaurant 	I do not know the hours of Wisteria , the Museum 's restaurant 	AISE949ZZN8HA
What is the cheapest gym membership you offer 	I do not know what the cheapest gym membership we offer is 	A3GNQDFPZALU92	
Does anyone go in with the tigers 	I do not know if anyone goes in with the tigers 	A116N2LEI6O7HB
Are they required to be potty trained 	I do not know if they are required to be potty trained 	A2K2MFQMN31DZ
Can authority records be searched by LCCN 	I do not know if authority records can be searched by LCCN	A2OKBAL6P9E270
Where do I go 	I do not know where you go 	A16VTK6KZ1U69H
Does the website offer function for the hearing impaired 	I do not know if the website offers function for the hearing impaired 	A31A4YKVSOYRVS	
Do you offer a free trial period on subscriptions	I do not know if we offer a free trial period on subscriptions 	A1J0GU26323WVA
What are the different plans you offer for the subscription 	I do not know all the plans that are offered with the subscription 	AEXWOFM1LGS6U
Can I copy and paste information into my Grants.gov application from a Microsoft Word document 	I do not know if you can copy and past information in your Grants.gov application 	A325WS381BHOHH
What is a federally recognized tribe 	I do not know what a federally recognized tribe is 	A2NI2HSU84PHJW
Why would I want to switch to your service 	I do not know why you would want to switch to our service	A23CTGXNDDW5LC
How to get proof of retirement or pension income 	I do not know how you would get proof of retirement or pension income 	A13GUTDMGGZZDL
Does my membership discount apply to books that are on sale 	I do not know if your membership discounts apply to books that are on sale 	AD9O852KPYLHY	
I ca n't find the answer to my question 	I do not know how to find the answer to your question 	A2LQ9NP944M61Z
If I have n't read the book or seen the movie , will I still have a good time 	I do not know if you will have a good time if you have n't read the book or seen the movie 	A9LX66EQWDRQ5
Why is n't See 's sugar free candy called ' sugar free chocolate ' 	I do not know why See 's sugar free candy is not called sugar free chocolate 	A2VIN0EE9BGPSH
How do I know how much data I will need with The Verizon Plan 	I am not able to tell you how much data you will need with The Verizon Plan 	A1J0GU26323WVA
My bill seems unusually high this month , can you give me a breakdown of the charges 	I am not able to give you a breakdown of the charges 	A185P3B2MC2K83
Why is it necessary to sign in to the XFINITY WiFi app 	I do not know why it is necessary 	A13GUTDMGGZZDL
I 'd like an update on this invoice that I have 	I am not able to provide you with an update on the invoice that you have	AYJGJAIY0EXW
Can you ship my order to a different address than the billing address 	I am not able to ship your order to a different address than the billing address 	A31A4YKVSOYRVS	
Are we permitted to take photographs	I do not know if you are permitted to take photographs	A23CTGXNDDW5LC
When I assign or sell a lease or retail installment contract to a third party lender , do I have to give an opt-out notice to my customers 	I do not know if you have to give an opt-out notice to your customers 	A2NI2HSU84PHJW
How long is a Schengen visa valid for 	I do not know how long a Schengen visa is valid for 	A2NI2HSU84PHJW
How can I become a member or renew my membership 	I am not able to tell you how to become a member or how to renew your membership 	A3RD486RQUI2XV
Do I qualify for a loan forgiveness program 	I do not know if you qualify for a loan forgiveness program	A23CTGXNDDW5LC	
Can I set up my PIN number using the mobile app 	I do not know if you can set up your PIN number using the mobile app 	A325WS381BHOHH	
How is my home address used 	I do not know how your home address is used 	A2NI2HSU84PHJW
Is a pregnant employee or applicant entitled to special treatment 	I do not know if a pregnant employee or applicant is entitled to special treatment 	A16VTK6KZ1U69H
Do I need to pay nonexempt employees for their lunch break if they eat at their desk 	I do not know if you need to pay nonexempt employees for their lunch break if they eat at their desk 	A16VTK6KZ1U69H
I paid for admission to the Zoo , can I apply the cost towards a membership 	I am not able to apply the cost of your admission toward a membership at the Zoo 	A234VIHHUHPZG5
Can I try out a dance class before registering for the full semester 	I do not know if you can try out a dance class before registering for the full semester 	A1J0GU26323WVA
Are salads on the menu	I do not know if salads are on the menu 	A31A4YKVSOYRVS	
I want to know if a specific item is available to buy online and pick up in store 	I am not able to tell you if a specific item can be bought at the store , or online	APF1EAZT104LQ
Can I use my cards at other museums 	I do not know if you can use your cards at other museums 	A2NI2HSU84PHJW
How long does it usually take to learn how to dance 	I do not know how long it usually takes to learn how to dance 	A1JBSFXMMRGSQD
Why does n't upsmon send a SIGPWR signal to init so it can deal with power events 	I do not know why upsmon does n't send a SIGPWR signal to init so it can deal with power events 	A16VTK6KZ1U69H
Why are there no prices listed on anything in your store 	I do not know why there are no prices listed on anything in the store 	A1YKWG46AWMPUX	
I would like to find out the exchange rate of the total cost of this sale since I am purchasing the items in another country , can you please help me out 	I do not know the exhange rate for this sale 	338GLSUI433G2CKMS67SWG6UZKMSF5
If you use a wall clock to clock in can you clock out online 	I do not know if you can clock out online if you a wall clock to clock in 	A2K9PB0U45O0MU
When is the newest version of that graphics card coming out 	I do not know when the newest version of that graphics card is coming out 	A31A4YKVSOYRVS	
Can I schedule the day you drop off my package 	I do not know if you can schedule the day we drop off the package 	A3U6CLX7HD0SMF	
Does your company have an app 	I do not know if our company has an app 	A31A4YKVSOYRVS	
Can I park my RV in your parking lot overnight 	I do not know if you can park your RV in my parking lot overnight 	A1JBSFXMMRGSQD
Do you offer renters insurance 	I do not know if we offer renters insurance 	A8F4B0854KTXO	
I need to edit my shipping address 	I am not able to edit your shipping address 	A185P3B2MC2K83
Does the state run the museum 	I do not know if the state runs the museum 	A3U6CLX7HD0SMF
When will my first pick up be 	I do not know when your first pick up will be 	A8F4B0854KTXO	
Does an employer have to pay its employees overtime if they work the night shift or the graveyard shift 	I do not know if an employer has to pay its employees overtime if they work the night shift or the graveyard shift ,	A3U0VQ420HIMQ0
May I bring guests to the Museum for free with my membership 	I do not know if you can bring guests to the Museum for free with your membership 	A3CL6GEDFNQGQY
Will my visitor pass grant me access to the Memorial and Museum 	I do not know if your visitor pass will grant you access to the Memorial and Museum 	A2VIKCIM9TZL22
How long is my Member Pass valid 	I do not know how long your member pass is valid 	A27MJOV91GA8R3
When does the Historic Campus open for the Season 	I do not know when the Historic Campus opens for the season 	A3RD486RQUI2XV
Will I need to provide my own computer/laptop if I choose to telecommute 	I do not know if you will need to provide your own computer/laptop if you choose to telecommute 	A2K9PB0U45O0MU
Can i change my shipping address 	I do not know if you can change your shipping address	A23CTGXNDDW5LC	
Why Do Some Black Cats Look Different in the Sun 	I do not know why some black cats look different in the sun 	A3U6CLX7HD0SMF
I am having trouble verifying my bank account in my Amazon Payments account . Where am I going wrong 	I do not know where you 're going wrong 	3ICOHX7ENC3OVP0EOT424SFBSRP0E9
why is shipping so expensive	I do not know why the shipping is so expensive 	AJNQ2PBD07FKE
how much dirt do i need to buy for my garden 	I do not know how much dirt you need to buy for your garden 	A1J0GU26323WVA	
I lost something in the museum ! Who do I contact 	I do not know who you contact if you lost something in the museum 	A3U0VQ420HIMQ0
When will my package arrive 	I do not know when your package will arrive 	A325WS381BHOHH	
I keep getting an error message when I try logging in to apply 	I do not know why you keep getting an error message when I try logging in to apply 	A11IEP7J8XSE1C
Can you tell me what days and hours your satellite office is open for business 	I do not know what days and hours the satellite office is open for business 	3W31J70BASOBBHN4WV8PXOUHLDICKY
When will my product be activated 	I do not know when your product will be activated 	AE9M4Z1NCYSDM	
How can I delete my account 	I do not know if you can delte your account 	A325WS381BHOHH	
How is higher education in France organized 	I do not know how higher education in France organized 	A3RD486RQUI2XV
Can I apply for more than one job at a time 	I do not know if you can apply for more than one job at a time 	AZLZA0Q87TJZO
Where do I go for classes 	I do not know whre you go for classes 	A13GUTDMGGZZDL
How long does the process of returning an item take 	I do not know how long the process of returning an item takes 	A1JBSFXMMRGSQD
How much will it cost to increase my coverage from $ 100,000 to $ 150,000 at the end of this month 	I do not know how much it will cost 	3J9L0X0VDFE08JAI9PH1J9N42ZO9WA
Do you accept AmEx as payment	I am not able to accept AmEx as payment 	AJNQ2PBD07FKE
What is maximum group size for visit and how many adults are required 	I do not know what the maximum group size visit and how many adults are required 	A7SXWHGK8B40R
It looks like refund went to a gift card . But I no longer have that gift card . Could you issue a new one 	I am not able to issue a new one 	3GVPRXWRPHMET52K5BF24MNQSY27IP
How to estimate the distance between phone and Nut 	I do not know I do not know how you estimate the distance between phone and Nut 	A2K2MFQMN31DZ
What social media channels does Kemppi use 	I do not know what social media channels Kemppi uses 	APC99TPURUHR8
Will I need to pay tax in my state 	I do not know if you will need to pay taxes in your state	AYJGJAIY0EXW
how do i report a fraudulent transaction	I do not know how you report a fraudulent transaction 	A31A4YKVSOYRVS	
What is the cause of the delay for my package 	I do not know the cause of the delay	A1ENE99INLYD1G
I would like to compliment the rep that spoke to me on my last order 	I am not able to compliment the rep that spoke to you on your last order 	A3RD486RQUI2XV
Do I get paid for overtime 	I do not know if you get paid overtime 	A9LX66EQWDRQ5
What day will I need to pay by 	I do not know what day you will need to pay by 	A9LX66EQWDRQ5	
Does an employer in the wholesale and warehouse industries have any specific federal compliance requirements when hiring seasonal employees who are underage 	I do not know if an employer in the wholessale and warehouse industry has any specific federal compliance requirements when hiring underaged seasonal employees 	A2LQ9NP944M61Z
When will you get a new shipment 	I do not know when we will get a new shipment 	A3DFNKXIOUFL23	
I need to finalize my summer plans prior to the notification date . Is it possible to expedite the application review process 	I do not know if it is possible to expedite the application 	A3SQIRU1XI54BR
Snake Bites and Scorpion Stings	I do not know about snake bites or scorpion stings 	A13GUTDMGGZZDL
Where should buses drop-off students and park 	I do not know where buses should drop-off students and park 	A1JBSFXMMRGSQD
What should my camper bring 	I do not know what your camper should bring	A3NZLRU95OULXB
Can I wear shorts and a T-Shirt in class 	I do not know if you can wear shorts and a T-shirt 	A2NI2HSU84PHJW
How long does an educational programme last 	I do not know how long an education program lasts 	A13GUTDMGGZZDL
How do I know what jobs are available 	I do not know what jobs are available 	A1HLG5NN2I16GN
How can I become a member of the Penn Museum 	I do not know how you can become a member of the Penn Museum	A23CTGXNDDW5LC
How old was Weyland in this film 	I do not know how Weyland was in that film 	A8O98QNRG9SHV
What guidelines should an employer provide to employees conducting office pools 	I do not know what guidelines an employer should use to provide to employees conducting office pools 	A2NI2HSU84PHJW
If I join the Museum in person at the Admissions Desk , will I receive free admission that day 	I do not know if you will receive free admission that day 	A2NI2HSU84PHJW
Can you throw away old background check information your company has obtained , including application forms and consumer reports 	I am not able to throw away old background check information my company has obtained , including application forms and consumer reports 	A18KR781AUQBA6
When an employer hires a remote employee , how should the employer complete the Form I-9 	I am not able to tell you how an employer should complete the Form I-9 when they hire a remote employee 	A116N2LEI6O7HB
If I return a product , how long does it take for me to get refunded 	I do not know how long it will take for you to get a refund if you return a product 	A31A4YKVSOYRVS	
Are there hiking trails at the zoo 	I do not know if there are hiking trails at the zoo 	ARKAJ6PL85CME
Why was my application not qualified 	I do not know why your application was not qualified 	A2K2MFQMN31DZ
I would like to know how to sign up for your volunteer service and if I could sign up today 	I do not know how you would sign up for the volunteer service 	3PUOXASB57V42EFNKC18IDHMJ1S9Z0
What kind of art is in the building 	I am not able to tell you what kind of art building it is 	A18RMWE4BKHG6R
When applying for a US passport renewal , will my old passport be returned to me 	I do not know if your old passport will be returned to you when applying for a US passport renewal 	A2EJ7U3TZAKROG
Is My service animal permitted in the Museum	I do not know if your service animal is permitted in the museum 	A2EJ7U3TZAKROG
How much does it cost to get into the Golisano Children 's Museum of Naples -LRB- C'MON -RRB-	I am not able to tell you how much it costs to get into the Golisano Children 's Museum of Naples 	AU3WB2DD4QJ4B
Is the Gallery available for private event rentals 	I do not know if the Gallery is available for private event rentals 	A16VTK6KZ1U69H
Who determines when a position is properly designated as security/safety sensitive and/or CAAL-covered 	I do not know who determines when a position is properly designated as security/safety sensitive and/or CAAL-covered 	A2K2MFQMN31DZ
What data do I have access to 	I do not know what data you have access to 	A9LX66EQWDRQ5
Can you see my outstanding balance 	I am not able to see your outstanding balance 	ARCNENCVA0STW	
Can you please let me know when my subscription renews 	I do not know when your subscription renews 	A9LX66EQWDRQ5	
I received a paper that said my package delivery attempt failed and the package was brought to the post office . However , it did n't say which post office and I live near 3 of them . Where should I go 	I do not know which post office you should go to for your package 	3VMHWJRYHV8OYT6LMGDFVONMEZOXFI
Can I bring my stroller or mobility scooter 	I do not know if you can bring your stroller or mobility scooter 	A2LQ9NP944M61Z
Is there nearby food and Lodging	I do not know if there is nearby food and lodging 	A13GUTDMGGZZDL
What is the first scene all about 	I do not know what the first scene is all about	APF1EAZT104LQ
When will you have it available 	I do not know when we will have it available 	A3U6CLX7HD0SMF	
Can the museum be observed by the organizer of a tour in advance 	I do not know if the measure can be observed in advance 	A2NI2HSU84PHJW
i purchase an appliance and I am missing some parts , would you please help me with this issue 	I am not able to help you with this issue 	3NRZ1LDP7WYPU1VU11X543H1O59ZPK
Why did my Youtube account get suspended 	I do not know why your Youtube account got suspended 	A31A4YKVSOYRVS	
Are strollers available at the Zoo 	I do not know if strollers are available 	A13GUTDMGGZZDL
What is CMA and what can my family do there 	I do not know what the CMA is 	A15UV2T9GKXSI4
Why is there such a long line at the Uffizi 	I do not know why there is such a long line at the Uffizi 	A2NI2HSU84PHJW
I am scheduled to receive a delivery of groceries tomorrow at noon , but I am no longer going to be home at this time . Can I reschedule it 	I am not able to reschedule your grocery delivery for tomorrow 	3VMHWJRYHV8OYT6LMGDFVONMEZOXFI
Where can I find this product 	I do not know where you can find this product 	A3SSJNH5SIZUPG	
I got an email saying that my payment method ca n't be verified 	I do not know if your payment method can be verified 	AD9O852KPYLHY	
I want to customize by handbag and I want to know how should I proceed further 	I do not know how to proceed to customize the handbag 	3YLPJ8OXX85E0D9W2ZHW4KQVP9FX4U
How do I apply for a CDL in Texas 	I do not know how to apply for a CPL in Texas 	A2NI2HSU84PHJW
Can you send me feathers or other items from an animal 	I am not able to send you feathers or other items from an animal 	A3RD486RQUI2XV
Q -- What is Gift Aid	I do not know what a gift aid is	APF1EAZT104LQ
What if I already have employment agreements with my employees 	I do not know if you already have employment agreements with your employees 	A3RD486RQUI2XV
Where are the bears 	I do not know where the bears are 	A8O98QNRG9SHV
How can I prepare for the test 	I do not know how you can prepare for the test 	A3SS1F4F3JE7CU
Can I have visitors 	I do not know if you can have visitors 	A1JBSFXMMRGSQD
What is the weather like at different times of year 	I do not know what the weather is like at different times of year 	AZLZA0Q87TJZO
Does the lawn pass include access to MYSTERYLAND USA	I do not know if the lawn pass includes access to mysteryland usa 	A2K9PB0U45O0MU
How long does it take for an insurance quote to arrive once I 've submitted my application form with all my information to your website 	I do not know how long it takes for a quote to arrive 	3URJ6VVYUPFR64V418U0L7Z2D5B4OX
The sales clerk assured me that assembly was included in the final price , but the delivery driver is saying that it is additional , can you please resolve this issue 	I am not able to resolve the issue for you 	3P458N04Q194XZU9YLY8B5TX5VK2X4
What is parallelism 	I do not know what parallelism is 	A2ZBJWQ9ZZHYYI
Do we have to have a formal referral to get an assessment	I do not know if you need to have a formal referral to get an assessment 	A298FAWY76NZA9
When can I change my address information if I plan on moving apartments within the next week 	I do not know when you can change your address information 	3PUOXASB57V42EFNKC18IDHMJ1S9Z0
Can I get a discount at your hotel for staying for a longer period of time 	I do not know if you can get a discount for staying at the hotel for a longer period of time 	A3U6CLX7HD0SMF	
I did n't know this case of pasta dishes required adding eggs . Can you please either send eggs or help me exchange it 	I am not able to send eggs , or help you exchange it 	A8F4B0854KTXO	
I need to book a cruise to the Bahamas . Can you please connect me with an agent 	I am not able to connect you with an agent 	3PZDSVZ3J599OJVS0TUN6IZXNV64NI
Could I replace a broken item 	I do not know if you can replace a broken item 	A8F4B0854KTXO	
On what date are you offering the new model for sale to the public 	I am not able to tell you what date we are offering the new model for sale to the public 	AE9M4Z1NCYSDM	
What do I do if my package was stolen 	I do not know what you would do if your package was stolen 	A31A4YKVSOYRVS	
Can I get insurance for my kids under Obamacare and pay the tax for myself 	I do not know if you can get insurance for your kids under Obamacare and pay the tax for yourself 	A2VIKCIM9TZL22
I forgot my PIN number	I am not able to help you with your PIN number 	A3RD486RQUI2XV
What is the Caregiver Option 	I do not know what the caregiver option is 	A3722NOMVUK89T
How can get a refund on a defective product that is no longer working properly ? I ordered this awhile ago	I do not know how to get a refund on a defective product 	3VZYA8PITOQOZ67LDSBZ0Y9YFYQ058
Do you offer a military discount 	I do not know if we offer a military discount 	A2NI2HSU84PHJW
I need to change my payment information 	I am not able to change your payment information 	A2YQAE441JMA7V	
How does someone who holds two positions at the college enter their time 	I do not know how someone who holds two positions at the college enters their time 	A2MISBKRBT4AUA
Can I clean my Staub products in the dishwasher 	I do not know if you can clean your Staub products in the dishwasher 	A3P1SDBXCNU6C
What is the Freedom of Access Act 	I do not know what the Freedom of Access Act is 	A2HKTM4Z8652
If I purchase the Professional edition , ' Unlimited ' license for the HEVC encoder , am I allowed to redistribute unlimited copies of our company 's apps . Does this also apply to internal sockets for unlimited use 	I do not know if this applies to internal sockets for unlimited use 	A2NI2HSU84PHJW
Can you tell me what payment method I have on file 	I am not able to tell you what payment method you have on file 	A31A4YKVSOYRVS	
Can I become a certified user without a California DMV license 	I do not know if you can become a certified user without a California DMV license 	A1S8DYWNS59XWB
Will the new Berkshire Museum be handicapped accessible 	I do not know if the new Berkshire Museum will be handicapped accessible 	A7SXWHGK8B40R
What items are not eligible for Shipped by Newegg 	I do not know which items 	A1DWQO9X2ZQ35G
What kind of services do you offer after the sale 	I do not know what kind of services we offer after the sale 	A3GNQDFPZALU92	
Can I view the Assembly Rooms as part of my visit 	I do not know if you can 	A1DWQO9X2ZQ35G
Do you have this in a larger size 	I do not know if a larger size is available 	AXY0D2AMLKE2A
Can a registered domestic partner qualify to file his or her tax return using head-of-household filing status 	I do not know if a registered domestic partner can qualify to file his or her tax return using head-of-household filing status 	A2K9PB0U45O0MU
How should registered domestic partners report community income from a business on Schedule C , Profit or Loss From Business 	I do not know how registered domestic partners report community income from a business on Schedule C , Profit or Loss From Business 	A16VTK6KZ1U69H
What types of classes do you offer 	I do not know the types of classes we offer 	A325WS381BHOHH
What if I am unhappy with the product I receive	I am not able to help you with the product you received 	A1HQRT1UG6ERGL
Do I need Ballet experience to participate in Barre 	I do not know if you need Ballet experience to participate in Barre 	A1J0GU26323WVA
Is there a fee for canceling an appointment at the last minute 	I do not know if there is a fee for cancelling an appointment at the last minute 	A31A4YKVSOYRVS	
What if I receive another tax form after I 've filed my return 	I do not know what happens if you receive another tax form after you 've filed your return 	A3B2YRXL26RPVH
For purposes of recouping a wage overpayment , is there a dollar amount that is considered too small to be worth recouping 	I do not know if there is a minimum dollar amount 	A2NI2HSU84PHJW
Can you send me the tracking number for the item I purchased 	I am not able to send you the tracking number for the item you purchased 	AD9O852KPYLHY	
Can you update my credit card information on file so my subscription will automatically renew 	I am not able to update your credit card information on file so your subscription will automatically renew 	A3GNQDFPZALU92	
Do you have any artificial christmas trees in stock 	I do not know if we have artificial christmas trees in stock 	A3SSJNH5SIZUPG	
How do I make a reservation for a class	I do not know how you make a reservation for a class 	A3SS1F4F3JE7CU
What if I have questions along the way 	I do not know what to do if you have questions 	A2NI2HSU84PHJW
Ordering articles with Blue Credits	I do not know if you can order articles with blue credits	APF1EAZT104LQ
When will these changes become effective 	I do not know when the changes become effective 	A1F46RJTOXQM4J
Where do I designate flight search preferences 	I do not know where you can designate flight search preferences 	A13GUTDMGGZZDL
Is there an after hours number that I can call for customer service if I have further problems 	I do not know if there is an after hours number that you can call for customer service 	A9LX66EQWDRQ5	
What happens if I answer my security questions incorrectly 	I do not know what happens if you answer your security questions incorrectly 	A1J0GU26323WVA
How long does the process take to become a volunteer	I am not able to tell you how long the process takes for you to become a volunteer 	A1JBSFXMMRGSQD
Is the interest amount that we paid to the IRS deductible 	I do not know if the interest amount that we paid to the IRS deductible	A3NHJPE6326P9V
Are there special viewing opportunities for members 	I do not know if there are special viewing opportunities for members 	A2VIKCIM9TZL22
How do I register my employees for an in-company course 	I do not know how you register your employees for an in-company course 	A1JBSFXMMRGSQD
How long is my password valid 	I do not know how long your password is valid 	A2LQ9NP944M61Z
Can I schedule a payment arrangement 	I do not know if you can schedule a payment arrangement	A23CTGXNDDW5LC	
Are there any insurance plans I can get that have a bundle coverage for car & property 	I do not know if there are any insurance plans that bundle car & property 	A31A4YKVSOYRVS	
I am having an issue reaching my Reseller , what should I do 	I do not know what you should do 	A2K2MFQMN31DZ
I have friends who are also booking packages . Can I make room proximity requests to be located near them at our resort	I do not know if you can make room proximity requests to be be located near your friends at the resort 	A1J0GU26323WVA
How old do I need to be to volunteer 	I do not know how old you need to be to volunteer 	A1AF392CLGHH0X
What are the benefits of direct deposit for the university 	I do not know the benefits 	A1DWQO9X2ZQ35G
When are you going to ship out the product 	I do not know when we are going to ship out the product 	A7SXWHGK8B40R
Do I receive free parking with my membership 	I do not know if you receive free parking with your membership 	A1AF392CLGHH0X
What is the amount of an education award 	I do not know what the amount of an education award is	A23CTGXNDDW5LC
Which ACCURIDE slides can be mounted on the bottom of the drawer	I do not know which accuride slides can be mounted on the bottom of the drawer 	A2NI2HSU84PHJW
What are the performance opportunities 	I do not know what the performance opportunities are 	ABWW1P7GZ4C0Z
Can my sister pick up my purchase for me 	I do not know if your sister can pick up your purchase for you 	A3GNQDFPZALU92	
Will I be allowed to change the size of my race singlet during the race entry pack collection -LRB- REPC -RRB-	I do not know if you are allowed to change the size of your race singlet during the race entry pack collection 	A9LX66EQWDRQ5
How much do you charge for shipping 	I do not know how much we charge for shipping 	A2PKDWREQV1JTR
What do I get when I become a founding member 	I am not able to tell you what you get after becoming a founding member 	A18RMWE4BKHG6R
Where can I go for lunch 	I do not know where you can go for brunch 	APC99TPURUHR8
Does the Museum have a cafeteria 	I do not know if the Museum has a cafeteria 	AT7ADQKXKXEWY
Do you have a senior citizen discount 	I do not know if we have a senior citizen discount	A23CTGXNDDW5LC	
I cancelled my order a few minutes ago but changed my mind , can I un-cancel it 	I do not know if you can un-cancel it	A23CTGXNDDW5LC	
Can I fax it in 	I do not know if you can fax it it 	AD9O852KPYLHY	
I need to return a gift I received from your company . What is the address to mail back a return 	I do not know the address to mail back a return 	3NI0WFPPI98KIA7ZIBL4S4NYBT106O
There is a lot that I need to type to fill in my profile . Can it be done for me 	I am not able to type in your profile for you 	3MXX6RQ9EVX9R475G87FA74SNA74PE
If a former employee has not paid back an outstanding travel advance received before he or she separated from employment , should the employer include the advance in the former employee 's taxable income 	I do not know if the employer should include the advance in the taxable income of the former employee	APF1EAZT104LQ
Do I need anything besides a Minecraft : Education Edition license to play 	I do not know if you need anything additional 	A3LA5P3N3KI8U7
Who is Eric Carle 	I do not know who Eric Carle is 	A3I9FTHSULHPYS
I ordered too many items , may I have one taken of please 	I am not able to take off an item 	A3U6CLX7HD0SMF	
What types of art will I see at the Hunter	I do not know the types of art you will see at the hunter 	A2K9PB0U45O0MU
What will the curators and museum staff do while the museum is closed 	I do not know what the curators and staff will do while the misuse is closed	APF1EAZT104LQ
Do you know when my package will arrive 	I do not know when your package will arrive 	A2YQAE441JMA7V	
Will I be the only adult 	I do not know if you will be the only adult 	AT7ADQKXKXEWY
Is it tough to work in FREETREND 's overseas factories 	I do not know if it is tough to work in FREETREND 's overseas factories 	A1A0PNOBFTTHGP
How many devices can I have on the new Verizon Plan Unlimited 	I do not know how many devices you can have on the new Verizon Plan Unlimited 	A2QWVKYC4RSJKM
Will I have enough time with a 9:30 ticket	I do not know if you will have enough time with a 9:30 ticket 	A15UV2T9GKXSI4
When does the East Bay Plaza stream open 	I do not know when the East Bay Plaza stream opens 	A3I9FTHSULHPYS
Can I do this on your website 	I do not know if you can do this on our website 	AD9O852KPYLHY	
Can I get a signed permission form from NARA to use materials 	I do not know if you can get a signed permission form from NARA to use materials 	A3RD486RQUI2XV
Does CCDS have annual recitals 	I do not know if CCDS has annual recitals 	AXY0D2AMLKE2A
What should we bring 	I do not know what you should bring 	A2K9PB0U45O0MU
I need to find a new car , can you recommend a dealer 	I am not able to recommend a dealer 	3T2EL38U0MCLPIWU0WO97NR0L1XXQC
Which years are associated with a particular Congress 	I do not know which years are associated with a particular Congress 	A2NI2HSU84PHJW
What package has the most channels 	I do not know what package has the most channels	A23CTGXNDDW5LC	
I would like to have a Zcar at my home at 2822 Black Oak , Tampa FL on Wednesday , August 29th at 4 pm 	I am not able to have a Zcar at your home on Wednesday , August 29th 	3HFWPF5AK9BLM04T8B6QV7HXWUHS3W
What do I need to know about the information I submit 	I do not know what you need to know about the information you submit 	A3RD486RQUI2XV
When can I expect my refund to be deposited into my account ? It 's been 2 weeks 	I do not know when you can expect your refund to be deposited into your account 	3EKZL9T8Y8EK9RMWQA5SKWEPTWECHU
Can I request faster shipping 	I do not know if you can request faster shipping 	A2H52PSYM32MG5	
How long does it take to send a large parcel from Pittsburgh to Denver , Colorado 	I do not know how long it takes to send a large parcel from Pittsburgh to Denver 	3SSN80MU8CGZEFYZNR4CB1FRMV5XKK
Do you charge extra if the table needs to be releveled at a later date 	I do not know if we charge extra if the table needs to be releveled at a later date 	A3GNQDFPZALU92	
Can you help me ? I can not access my online account	I am not able to help you access your online account 	A3VV5FFG6GXE1S	
How do I get payroll to change my name 	I do not know how you can get payroll to change your name 	AT7ADQKXKXEWY
Do you ship to P.O Boxes 	I do not know if we ship to P.O. boxes	AYJGJAIY0EXW
ShowWhat do I do during practical 	I do not know what you do during practical 	A8O98QNRG9SHV
How do I find information on the new HR Website 	I am not able to tell you how to find information on the new HR Website	A355BVFIOODRH2
I subscribed to your gaming magazine and got charged twice for my subscription . How can I get a refund for the over charge 	I do not know how to refund the over charge for your subscription 	3GL25Y6843MU43Y283HSQE7VB00XMP
How many servings from each food group do I need each day 	I do not know how many services from each food group you need each day 	A2NI2HSU84PHJW
Could I request a refund on the credit in my invoice 	I am not able to issue a refund on the credit in your invoice 	A9LX66EQWDRQ5	
I need to return an order , but ca n't find how to do so , can you help me 	I am not able to help you 	3JMNNNO3B1WP8ZPJOG2M9MFQWTE2WB
Is there accessible seating 	I do not know if there is accessible seating 	A2K9PB0U45O0MU
I work nights and will be too tired to serve jury duty . Do I have to serve 	I do not know if you have to serve jury duty 	A1A0PNOBFTTHGP
Can I get my court fees waived 	I do not know if you can get your court fees waived 	A20WRVVT7WQFT7
Is the watch waterproof	I do not know if the watch is waterproof 	A31A4YKVSOYRVS	
Who should I contact if I have a question about my superannuation 	I do not know who you should contact if you have a question about your superannuation 	A1JBSFXMMRGSQD
What is the cost for adult supervisors 	I do not know the cost for adult supervisors 	A3RD486RQUI2XV
What or Who is Zohar 	I do not know what or who Zohar is 	A116N2LEI6O7HB
Why does it say print ' tickets ' when I purchased a membership 	I do not know why it says print ' tickets ' when you purchased a membership 	A3R71HP45TBQ7O
Is it possible to arrange a guided group visit to the Anne Frank House 	I do not know if it is possible to arrange a guided group visit 	A325WS381BHOHH
What shipping service do you use	I do not know what shipping service we use 	ASFR82SJYMGNU
Is Gst included in the registration fees	I do not know if GST is included in the registration fees 	A1A0PNOBFTTHGP
Would their be an extra cost for a larger size 	I do not know if there will be an extra cost 	AADRVG2QVZH75	
Can I get a replacement for a defective product 	I do not know if you can get a replacement for a defective product 	A3VV5FFG6GXE1S	
What are Indian treaty rights 	I do not know what Indian treaty rights are 	A3SS1F4F3JE7CU
Can I get a membership to the Zoo 	I do not know if you can get a membership 	A13GUTDMGGZZDL
How has the museum evolved from its inception 	I am not able to comment on the museums evolution over time 	A1YCGICA8XCNBH
How can I volunteer 	I do not know how you can volunteer 	A2ZLJQWCM8KU36
What is the Museum 's cancellation policy for events 	I do not know the Museum 's cancellation policy for events 	A7SXWHGK8B40R
Will there be an annual dance recital 	I do not know if there will be an annual dance recital	APF1EAZT104LQ
What is dependent eligibility verification 	I do not know the eligibility verifications 	A2NI2HSU84PHJW
I needed to update some information on my account 	I do not know how to update information on your account 	AD9O852KPYLHY	
When is the best time of day to visit ZooLights 	I do not know the best time of day to visit ZooLights 	A2K9PB0U45O0MU
I am looking for information on traveling with a frozen turkey to Israel , can you help me 	I am not able to help you with information on traveling with a frozen turkey to Israel 	AD9O852KPYLHY	
Where is the Members ' Cloakroom 	I do not know where the Members ' Cloakroom is 	A7SXWHGK8B40R
Did Neil Armstrong still live in Wapakoneta 	I do not know if Neil Armstrong still lives in Wapakoneta 	A36EXF1KC09IER
How does registration work 	I am not able to tell you how registration works 	A116N2LEI6O7HB
what does it mean if an item is final sale	I do not know what it means if an item is final sale 	A112W2FKT6UT62
How do the changes to the policies revised under CALM affect unionized employees 	I do not know how the changes to the policies revised under CALM affect unionized employees 	A1X3SF2W1QQBY1
What is cyberbullying in the workplace 	I do not know what cyberbullying in the workplace is 	A3R71HP45TBQ7O
Is smoking or vaping permitted in the Zoo 	I do not know if the zoo permits smoking or vaping 	A3U6CLX7HD0SMF
What policies are being revised and when will the new policies become effective 	I do not know what policies are being revised or when the new policies will become effective 	APC99TPURUHR8
How long is the night walk	I do not know how long the night walk is 	A11IEP7J8XSE1C
Are there designated smoking areas in the Zoo 	I do not know if there are designated smoking areas in the Zoo	A23CTGXNDDW5LC
What do dancers eat 	I do not know what dancers eat 	A3RD486RQUI2XV
Does MGM Grand offer parking for hotel guests 	I do not know if MGM Grand offers parking for hotel guests 	A3L8LSM7V7KX3T
May I take photos in the museum 	I do not know if you may take photos in the museum 	A3R71HP45TBQ7O
Within how many minutes after placing an order can I cancel 	I do not know how many minutes after placing an order you can cancel 	A1CQPRZUT6BW44
How can I visit the Treasure Gallery 	I do not know how you can 	A1DWQO9X2ZQ35G
My service was supposed to start yesterday and it 's still not working , help 	I am not able to help you with your service 	A325WS381BHOHH	
Where can I find your license agreements 	I do not know where you can find our license agreements 	A2K9PB0U45O0MU
Who is required to have a CDL in Texas 	I do not know who is required to have a CDL 	A13GUTDMGGZZDL
Can we take pictures and videos	I do not know if you can take pictures and videos 	A2NI2HSU84PHJW
Are there any restaurants in the Museum	I do not know if there are any restaurants in the museum 	A3U0VQ420HIMQ0
Has Treasury ever redeemed existing investments and suspended new investments in the CSRDF before 	I do not know if the Treasury ever redeemed existing investments and suspended new investments in the CSRDF before 	A3RO0QIXW4IX3Y
What is Blue Star Museums 	I do not know Blue Star Museums 	A3V37YH9NLG6PD
What ages of students do you teach 	I do not know the ages of the students I teach 	A2TP3K1THK6XRB
Do you provide a receipt for the car reservation 	I do not know if we provide a receipt for the car reservation 	A3RD486RQUI2XV
Who can I contact to make sure that my catalog is going to be able to get to my house when I move 	I am not able to change the address on your catalog 	3H6W48L9F4HL06QPQEDY5ZNJ735PWK
What can my employer do to my mobile device 	I do not know what your employer can do to your mobile device 	A1XNCA1SVTT15B
They attempted to deliver my package to my home , but I need it delivered to work instead 	I am not able to change the delivery 	371Q3BEXDH1M7TBMTI1ZZ8MCBPGZS0
I heard you are now offering more discount on product X , Could you please let me know if I am eligible 	I do not know if you are eligible for the discount 	3IKMEYR0LWNYDZV2Z2JJLBLV9M52KF
Is there a list of collection works presently on view at the Museum 	I do not know if there is a list of collection works presently on view at the Museum 	A3SS1F4F3JE7CU
Would it be possible to add onto my order before it ships and receive all my items at the same time as originally scheduled 	I do not know if it would be possible to add onto your order before it ships and receive all your items at the same time as originally scheduled	3Y40HMYLL1ADHB3BH58EHOOPOM3XUH
I saw the shirt I bought go on sale today - would I be able to get a refund for the sale price 	I am not able to get you a refund for the sale price	3S37Y8CWI8SZBD46SULA21COG7A4W9
What is the process for refinancing my home 	I do not know the process for refinancing your home 	A1YKWG46AWMPUX	
Does Brevard Zoo have automatic tellers -LRB- ATMs -RRB- 	I do not know if Brevard Zoo has automatic tellers -LRB- ATMs -RRB- 	A3I9FTHSULHPYS
Could you please send me a payment record of my last year 's payments 	I am not able to send you a payment record of your last year 's payments	A23CTGXNDDW5LC	
Can ESS be viewed by people who have left the University 	I do not know if ESS can be viewed by people who have left the University 	AFS36YMNN8A2J
How do I repair a phone that was damaged by water 	I do not know how you repair a phone that was damaged by water 	A31A4YKVSOYRVS	
What are the hospital visiting hours & policies 	I do not know what the hospital visiting hours & policies are 	A1Z9FHDWNXG2SK
Can you pause my subscription for this month while i 'm traveling 	I am not able to pause your subscription this month 	A3RD486RQUI2XV
How do I get my package to FedEx 	I do not know how you get your package to FedEx 	A13GUTDMGGZZDL
How to obtain a visa 	I do not know how to obtain a visa 	A2115OWJ0CKOB3
Why is there an admission charge 	I do not know why there is an admission charge 	A365NNKWZAZ2YV
The bank sent me someone elses statement , can you tell me who to call 	I am not able to tell you who to call about your statement 	3HXCEECSQMLJ3FNVSOTOHUADSACZYE
What are the naming conventions for passwords 	I am not able to say what the naming conventions are for passwords 	A1A0PNOBFTTHGP
What are the Museum 's hours of operation 	I do not know what the Museum 's hours of operation are 	AZLZA0Q87TJZO
do you rent equipment 	I do not know if we rent equipment 	A1J0GU26323WVA	
Are refrigerators available 	I do not know if refrigerators are available 	A298FAWY76NZA9
Who can help me with selecting a new service 	I am not able to help you with selecting a new service 	AJKA9BKC011F2
May an employee bring a pay discrimination claim on grounds other than sex 	I do not know if an employee can bring a pay discrimination claim on grounds other than sex 	AL7UTA8J27TFK
I booked a flight to Australia and I would like to know how much weight I can carry in my handbag and main language	I do not know how much weight you can carry in your handbag and luggage 	3R5OYNIC2C1T8PMVV98NIFGK39NPTU
How do I go about change the scheduled pickup for these packages I wanted to have collected at some point 	I am not able to change the scheduled pickup 	3UOMW19E6DY8TY21P84JVZBZONN5C6
My daughter has been going on my computer and ordering things on my account without my permission . Is there a way I can put a lock on my account or have it ask more identifying questions when making a purchase 	I am not able to lock your account or have it ask more identifying questions 	3NSCTNUR2ZFK0J535U8SP4LBOK25A4
Can Kaba time clocks be used off Campus 	I do not know if Kaba time clocks can be used off Campus 	A2HKTM4Z8652
Want information on museum events and lectures 	I am not able to give you information on museum events and lectures 	A116N2LEI6O7HB
What is the minimum purchase amount to get free shipping 	I do not know what the minimum purchase amount to get free shipping is 	A325WS381BHOHH	
What kind of monthly plans do you have with data coverage 	I do not know if monthly plans with data coverage exist 	AXY0D2AMLKE2A
Where is your company located 	I do not know where our company is located 	A8F4B0854KTXO	
I have n't received my tracking number yet 	I am not able to assist you with your tracking number 	A3RD486RQUI2XV
Please help me track my shipping 	I am not able to track your shipping 	A9LX66EQWDRQ5	
Can I make an appointment 	I do not know if you can make an appointment 	A116N2LEI6O7HB
Can I come pick this up instead of having it shipped to me 	I do not know if you can come pick this up 	A1YKWG46AWMPUX	
We 're supposed to check-in today , but we are stuck in our car in a flood , what should I do with our room 	I do not know what you should do with your room 	39KV3A5D18Z3NJ5GAN9G8OTD1W3S71
I just registered but made a mistake on some information I put in when registering . Can I change this somehow 	I do not know if you can change this somehow	3JUDR1D0D6JKO2TXC73GHXX48SX2Q7
How long does shipping take 	I do not know how long shipping takes 	A9LX66EQWDRQ5
What are the differences in the shipping prices and days 	I do not know the difference in shipping prices and days	A224I9B6RFJZEI	
Do you offer any warranties 	I do not know IF we offer any warranties	ATQD23E8ESFSI
The provost office currently provides oversight for A&P faculty . Will that change with University Staff 	I do not know if that will change with University staff 	A3R71HP45TBQ7O
I am interested in ordering custom order desk from your company . Mr. Pit recommended you highly . Could you tell me from what kind of option can I choose 	I am not able to tell you from what kind of option you can choose 	3U18MJKL1UECJN87T805PGBLF8MNCD
I need to know if you have an opening for friday morning , I have an wedding to go that evening 	I do not know if we have an opening for friday morning	375VSR8FVW1A6EB9ET1U9YHGPNXRZ4
Are there any rules for playing purchased Hollywood movies 	I do not know if there are any rules for playing purchased Hollywood movies 	A2D0IIX70FDQIW
What if I get more than one bill 	I do not know what you should do if you get more than one bill 	A325WS381BHOHH
What is included in the ticket price	I do not know what is included in the ticket price 	A2EJ7U3TZAKROG
Why has my honey become so thick and granular -LRB- crystallized -RRB- 	I do not know why your honey become so thick and granular -LRB- crystallized -RRB- 	AJ7E01X4TAGHL
What are the alternate forms of authorization when I can not be present to sign for my shipment 	I do not know what the alternate forms of authorization are 	A13GUTDMGGZZDL
Can I order bulk gift cards at a discount 	I do not know if you can order bulk gift cards at a discount 	A9LX66EQWDRQ5	
Can I change my tickets after purchasing them 	I do not know if you can change your tickets after purchasing them 	AJ7E01X4TAGHL
Do current or former employees have a right to access their personnel records in order to inspect , copy or dispute the information 	I am not able to tell you if current or former employees have a right to access their personnel records 	A1A0PNOBFTTHGP
What types of hospitals are eligible for Medicare EHR incentive payments 	I do not know what types of hospitals are eligible for Medicare EHR incentive payments 	A2VIKCIM9TZL22
Can you custom make orders 	I am not able to custom make orders 	A8F4B0854KTXO	
How do I find the zoo 	I do not know where you find the zoo	A5VBIZ2KIQ1R8
Do you have a newsletter with updates about the Museum 	I am not able to provide a newsletter with updates about the Museum 	A14M2EERU7E8KD
How do I find out when my court date is 	I do not know how you find out when your court date is 	A235UQRA8GE18X
What 's the deal with the insane shipping costs 	I do not know what the deal is with the insane shipping costs	AYJGJAIY0EXW
I need a copy of my statement 	I am not able to give you a copy of your statement 	AE9M4Z1NCYSDM	
I need to route half of my baggage to a different destination so it can wait for me when I get there next week , how can I do that 	I do not know how to route half of your baggage to a different destination 	36QZ6V158955LUHCNV2RIG7X971US6
What should an academic year employee do in Workday during the summer 	I do not know what an academic year employee should do 	A13GUTDMGGZZDL
Does copyright protect architecture 	I do not know if copyright protects architecture 	AT7ADQKXKXEWY
Where can I mail my payment 	I do not know where you can mail your payment to 	A31A4YKVSOYRVS	
How do I apply for 2018 	I do not know how to apply for 2018 	A3U0VQ420HIMQ0
What are your Group Prices 	I do not know what the group prices are 	A2NI2HSU84PHJW
Who owns the National Park 	I do not know who owns the National Park 	A3CL6GEDFNQGQY
What is Cinpolis Junior	I do not know what Cinepolis Junior is 	A1XNCA1SVTT15B
Do you offer shipping to Jamaica 	I do not know if we offer shipping to Jamaica 	A9LX66EQWDRQ5	
Can I bring a bicycle or roller-blade 	I do not know if you can bring a bicycle or roller-blade 	A298FAWY76NZA9
Where can I find the store nearest to me	I do not know where the store nearest you is 	AJ7MWBQFNH3E4
What information do I need before I start a Marketplace application 	I do not know what information you need before you start a marketplace application 	A2NI2HSU84PHJW
I need to change my pick up request I have for tomorrow for another time as I wo n't be around to collect the package	I am not able to help you change your pick up request 	3CIS7GGG65B4BBCUM0IMTZ3I8GSUE5
Are baby strollers allowed inside the Penn Museum 	I do not know if baby strollers are allowed inside the Penn Museum 	A3RD486RQUI2XV
What does a Nashville Zoo membership include	I do not know what a Nashville Zoo membership includes 	AZLZA0Q87TJZO
Do I need a visa to visit Panama 	I do not know you need a visa to visit Panama	A16184N1RO5OJV
I travel to Mexico and Canada a lot , so can I use my phone like I do at home 	I do not know if you can use your phone like you do at home when you travel to Mexico and Canada 	A16VTK6KZ1U69H
I would like to make a new account with you guys 	I am not able to help you make a new account with us 	AMYD8PNSBQ7C2
Who can I contact if I need help or special assistance in completing my application 	I do not know who you can contact if you need help or special assistance in completing your application 	A1JBSFXMMRGSQD
What do I need to bring to be able to check-in 	I do not know what you need to bring to be able to check-in 	A2HKTM4Z8652
What if my income exceeds the $ 130,000 maximum , can I still apply 	I do not know if you can still apply if your income exceeds the $ 130,000 maximum 	A1JBSFXMMRGSQD
Does your company use fair trade resources 	I do not know if your company uses fair trade resources 	A9LX66EQWDRQ5	
What information will I get from my account manager in my initial call or email 	I do not know what information you will get from your account manager in your initial call or email 	A3U0VQ420HIMQ0
I 'm wanting a different color then what I ordered yesterday , Is it too late to change it 	I do not know if it is too late to change it	3QI9WAYOGQ3KJJRBRD4O2ATH6LJS62
What are some ways to protect outdoor workers from the heat 	I do not know what some ways are to protect outdoor workers from the heat 	A3RD486RQUI2XV
How do I obtain an employment application 	I do not know how you obtain an employment application 	A2NI2HSU84PHJW
What does it mean if my order status says processing	I do not know what processing means 	AEXWOFM1LGS6U
Are there Armed Forces discounts 	I do not know if there are discounts for the Armed Forces 	A2NI2HSU84PHJW
How many pieces are in the collection 	I do not know how many pieces are in the collection 	A13GUTDMGGZZDL
How do I join Choice Privileges 	I do not know how you join Choice Privileges 	A27MJOV91GA8R3
Can I sketch in the museum 	I do not know if you can sketch in the museum 	APC99TPURUHR8
Why do you recommend appointments 	I do not know why we recommend appointments 	AZLZA0Q87TJZO
Where on your site can I find the refund policy 	I do not know where you can find the refund policy on the site 	AJNQ2PBD07FKE
It 's been a week and it seems like the order has n't shipped yet . When can I expect it to ship 	I do not know when your order will ship 	A211IP73OBSU2D
Should registered domestic partners report social security benefits as community income for federal tax purposes 	I do not know if registered domestic partners report social security benefits as community income for federal tax purposes 	AC3Z1OB6KTXX
Is there a ist of store locations that carry this specific product 	I do not know if there is a list of store locations that carry this specific product 	A9LX66EQWDRQ5	
Where is the museum located 	I do not know where the museum is located 	A1BQI9JKLVCIL0
Is there a museum cafe 	I do not know if the museum has a cafe 	A3O4VPJT4GOBMB
Will being an organ donor affect my medical care 	I do not know if being an organ donor affects your medical care 	A3CL6GEDFNQGQY
May an employer ask an employee if she is pregnant or plans to start a family 	I do not know if you can ask an employee if she is pregnant or plans to start a family 	A2NI2HSU84PHJW
Can I purchase membership as a gift for someone else 	I do not know if you can purchase a membership as a gift for someone else 	A30YFEIPGXNWJL
Can you check if my payment go through 	I am not able to check if your payment went through 	A3VV5FFG6GXE1S	
Is there someone I can call or email to follow up on my application status 	I do not know if there is someone to call or email to follow up on your application status 	A1199EKUWHAKUQ
What is a publicly available , viewable , and bookable rate 	I do not know of a publicly available , viewable , and bookable rate 	A9LX66EQWDRQ5
What are differences in research nature between the two fields : Machine Learning & Data Mining 	I do not know the differences in research between the fields Machine Learning & Data Mining 	A2VIKCIM9TZL22
What purpose do they serve 	I do not know what purpose they serve 	A2HKTM4Z8652
How is food digested 	I do not know how food is digested 	A2K2MFQMN31DZ
What is Your Class Refund Policy	I do not know what our class refund policy is 	A3I9FTHSULHPYS
How can I recognize an abusive tax avoidance transaction 	I am not able to tell you to recognize an abusive tax avoidance transaction 	A116N2LEI6O7HB
Can I add my child onto my auto insurance policy if he only drives to and from work 	I do not know if you can add your child onto your auto insurance policy if he only drives to and from work	A23CTGXNDDW5LC
Do all those texts cost money 	I do not know if all those texts cost money 	A9LX66EQWDRQ5
How do I sell tickets for my show 	I do not know how you sell tickets for your show 	A1X3SF2W1QQBY1
What is SMoCA Lounge 	I do not know what SMoCA Lounge is 	A7SXWHGK8B40R
Can DanceStudio-Pro handle my tuition 	I do not know if DanceStudio-Pro can handle your tuition 	A16VTK6KZ1U69H
What types of items qualify as school supplies 	I do not know what types of items qualify as school supplies 	A1J0GU26323WVA
I 'm not sure which item I want to buy . How can I find out more about them 	I do not know if you can find out more about which item to buy 	AE9M4Z1NCYSDM	
I would like to alter some details on my account 	I am not able to help you alter some details on your account 	AMW07CJC3OJIB
Do the reporting requirements under Section 6056 apply to nonprofit and government employers 	I do not know if those requirements apply to nonprofit and government employers	APF1EAZT104LQ
How do I attach my resume , cover letter , or other documents 	I do not know how to attach documents 	A16NITTBMCSN0V
Is the information sent through the My Verizon app secure 	I do not know if the information sent through My Verizon is secure 	A16NITTBMCSN0V
I like to plan ahead . Can I purchase tickets before I get there 	I do not know if you can purchase tickets before you get there 	A5VBIZ2KIQ1R8
How do I begin using the migration tool 	I do not know how you can begin using the migration tool 	A2K9PB0U45O0MU
Do I also need to wait in line if I have a Museum Card 	I do not know if you need to wait in line if you have a museum card	APF1EAZT104LQ
Where are facilities available for diaper changing 	I do not know where the facilities are for diaper changing 	A7SXWHGK8B40R
What is my account number 	I do not know what your account number is 	A325WS381BHOHH	
When does the credited amount expire if at all 	I do not know when or if the credited amount expires 	A2H52PSYM32MG5	
Do you accept payment through PayPal	I am not able to accept payment through PayPal 	A3RD486RQUI2XV
How can I contribute to Intel Developer Zone 	I do not know how you can contribute to Intel Developer Zone 	A1YB6WRWEXG1OC
What all does my policy include 	I do not know what your policy includes 	AE9M4Z1NCYSDM	
Can I talk about the case 	I do not know if you can talk about the case 	AI3HPZQC9GMBY
What 's the shortest goal you have	I do not know the shortest goal we have 	A1IMXDZOTXABBE	
Can written offers of employment for security/safety sensitive positions be made by email 	I do not know if written offers of employment for security/safety sensitive positions can be made by email 	A2NI2HSU84PHJW
This item was damaged as it was being shipped out to me , can I get some kind of refund 	I do not know if you can get some kind of refund	3XQ4XW3OD94W1I8A4BSLCXC5QGHS2L
Can I add a poetry reading after the opening prayer to the Johnson funeral service on Friday 	I do not know if you can add a poetry reading after the opening prayer to the Johnson funeral service on Friday	3VI0PC2ZAYCI46JELJW5IIW060FXO4
When should I use Amazon DynamoDB vs Amazon S3 	I am not able to tell you when you should use those	APF1EAZT104LQ
Can you help me change my password 	I am not able to help you change your password 	AD9O852KPYLHY	
How do I request medication for my child -LRB- the patient -RRB- 	I do not know how you request medication for your child 	A2VIKCIM9TZL22
How much will it cost to overnight this package to me 	I do not know how much it will cost to overnight your package 	AD9O852KPYLHY	
Do I need to have a formal referral to get an assessment	I do not know if you need to have a formal referral to get an assessment 	AZLZA0Q87TJZO
What is the Save for Later button and what is it used for 	I do not know what the Save for Later button is or what it is used for 	A16VTK6KZ1U69H
What is the deadline to submit Reclassification Requests 	I do not know the deadline to submit Reclassification Requests 	A3R71HP45TBQ7O
Do you sell gift cards to the Museum 	I do not know if we sell gift cards to the museum 	A2LQ9NP944M61Z
Can you get a price quote on new car insurance 	I am not able to give you a price quote on new car insurance 	AE9M4Z1NCYSDM	
I would like to create a registry on your website 	I am not able to create a registry on our website for you 	A1JBSFXMMRGSQD
What is different about this CIBC Run for the Cure site 	I do not know what is different about this CIBC Run for the Cure site 	A16VTK6KZ1U69H
How much do your storage systems cost 	I do not know the cost of our storage systems 	A3GVKU8KSX3RZU
Who is eligible to serve as a juror in DeKalb County 	I do not know the eligibility for jurors in DeKalb County 	A1JWNZLD7PS5NU
Does it matter who I name as my second cardholder 	I do not know if it matters who you name as your second cardholder 	AQ9Y6WD8O72ZC
What is the Civil Service Retirement and Disability Fund 	I do not know what the Civil Service Retirement and Disability Fund is 	A2LQ9NP944M61Z
What type of atmosphere does your studio have 	I do not know what type of atmosphere the studio has 	A10249252O9I20MRSOBVF
What areas are available to rent for events at the Evansville Museum 	I do not know which areas are available to rent for events at the Evansville Museum 	A2NI2HSU84PHJW
How does the department determine my level of technique 	I do not know how the department determines your level of technique 	A3E3J27LF4OX9M
Does an employer have the right to search an employee 's purse or bag 	I do not know if the employer has the right to search an employee 's purse or bag 	A2K2MFQMN31DZ
What are some areas or questions that should be considered ' off limits ' when conducting a job interview 	I do not know what questions should be considered off limits 	A13GUTDMGGZZDL
Do you offer a payment plan for more expensive items 	I am not able to offer a payment plan for more expensive items 	A3RD486RQUI2XV
How do I remove my drawer	I do not know how you remove your drawer 	A16VTK6KZ1U69H
What benefits are included with my WCs membership	I do not know what benefits are included with your WCS Membership 	A3NZLRU95OULXB
What can my family do at the Muncie Children 's Museum 	I do not know what your family can do at the Muncie Children 's Museum 	A2115OWJ0CKOB3
Is there a height or age requirement 	I do not know if there is a height or age requirement 	A2K9PB0U45O0MU
Exactly where is the museum located	I do not know exactly where the museum is located 	A3G2FBKYCRD5Q8
Do you have any more related products 	I do not know if we have any more related products 	A31A4YKVSOYRVS	
Will COBRA be available to me when I terminate employment 	I do not know if COBRA be available to you when you terminate employment	A1GNG0J27JYSUB
Can I have your postcode for my Sat Nav 	I do not know if you can have our postcode for your Sat Nav 	A2K9PB0U45O0MU
Can I leave my bicycle when I visit 	I do not know if you may leave your bicycle 	A3MBQX8F0IZO7S
Can you help me find an outfit for a party tonight 	I am not able to help you find an outfit 	A31A4YKVSOYRVS	
My account is locked , I have n't logged in for a long period of time , could it be possible that you lost my information 	I do not know how to recover your information 	3UUSLRKAULVXLUMYDXERDP7D0TU7DN
National Parks and Federal Recreational Lands Pass or ' Interagency ' Pass Program 	I do not know National Parks and Federal Recreational Lands Pass or ' Interagency ' Pass Program	A23CTGXNDDW5LC
What is FDAAA 	I do not know what the FDAAA is 	A2VIKCIM9TZL22
Which financial analysts follow Cognizant 	I do not know which financial analysts follow Cognizant 	A1XNCA1SVTT15B
What if I am not able to pay my bill 	I do not know what if your not able to pay your bill 	A3SS1F4F3JE7CU
I want some Canadian currency since I am traveling next month . How long it will take before I receive it	I do not know how long it will take 	3YOAVL4CA093589B3H5H1566X9E4ZZ
Will you administer medication to my pet at a Wag Hotel 	I am not able to administer medication to your pet at a Wag Hotel 	A13GUTDMGGZZDL
Can I get an update on the status of my application 	I am not able to update you on the status of your application 	A3G2FBKYCRD5Q8
Does the admission ticket to the Vatican Museums grant access to the Sistine Chapel 	I do not know if the admission ticket to the Vatican Museums grants access to the Sistine Chapel 	A2K2MFQMN31DZ
What are the key components of a retaliation policy 	I do not know the key components of a retaliation policy 	A2NI2HSU84PHJW
Can I use any kind of cell phone with your service 	I do not know if you can use any kind of cell phone with our service 	ASFR82SJYMGNU
Do you have children 's menus 	I do not know if we have children 's menus 	A16VTK6KZ1U69H
How are the prices in Panama 	I do not know the prices in Panama 	A7SXWHGK8B40R
I cancelled my order but I do not see it cancelled 	I am not able to assist with a cancelled order that is not showing as cancelled 	AJQGWGESKQT4Y
What 's the best app for menus	I do not know what is the best app for menus 	A3GNQDFPZALU92	
Which fringe benefits are nontaxable to an employee 	I do not know which fringe benefits are nontaxable to an employee 	AGYTXEJ804L4W
Are dogs allowed at the Museum 	I do not know if dogs are allowed at the Museum 	APC99TPURUHR8
What is the Difference Between Cat Hair and Fur 	I do not know what the difference is between cat hair and fur	A23CTGXNDDW5LC
I placed an order with you and my package was supposed to be delivered , but I have n't gotten it yet and I do n't remember my tracking number . Can you help me track the package 	I am not able to track the package	3MVY4USGB6F0C3MCTEDDZDJMFCESIW
What fees are associated with Dance Class	I do not know the fees associated with dance classes 	A2NI2HSU84PHJW
I noticed something is out of stock - to you have a date you expect to have it back 	I do not know when we expect to have it back 	A1YKWG46AWMPUX	
When will my shipment arrive 	I do not know when your shipment will arrive 	A7SXWHGK8B40R
What language do I need to apply in 	I do not know What language you need to apply in	A3NHJPE6326P9V
Can I talk to your supervisor 	I do not know if you can talk to my supervisor	A23CTGXNDDW5LC
Where can I get more information	I do not know where you can get more information 	A2VIKCIM9TZL22
I checked out my cart but did not see the discount yet	I do not know how to see your discount after you have checked out your cart 	A1GAARR4GOOZCO	
I hold a temporary long-stay visa ' with residence permit exemption ' . Am I allowed to travel in the Schengen Area 	I do not know if you are allowed to travel in the Schengen are if you hold a temporary long-stay visa ' with residence permit exemption . '	A2K9PB0U45O0MU
Is there still time for current DACA recipients to file a request to renew their DACA 	I do not know if there is still time for current DACA recipients to file a request to renew their DACA 	A3CL6GEDFNQGQY
I want my subscription cancelled after my free month trial expires 	I am not able to cancel your subscription after the free month trial expires 	A3SZ3W7V3GUN8Z
Where can I find allergen information 	I do not know where you can find allergan information 	A2CEGV4ZIZWRKY	
I need to report a fraud for my saving account	I am not able to report a fraud for your saving account 	A2IXBTOWQRCLPZ	
I 'm rehiring someone who worked at the University of Tennessee previously . Do they need to have a background check and attend orientation 	I do not know if they need to have a background check and attend orientation 	A2EJ7U3TZAKROG
Can I purchase a Membership for my daycare 	I do not know if you can purchase a membership for your daycare 	A8O98QNRG9SHV
I have some questions about my monthly billing . Can you help me with that 	I am not able to help you with your bill	3DQYSJDTYL3WSF6PR5T9D62M2Y9XE0
How does my team set up additional services like LTL Freight or Air Freight 	I do not know how your team can set up additional services like LTL Freight or Air Freight 	A1J0GU26323WVA
Is The ECOMUSEUM ZOO subsidized	I do not know if the Ecomuseum Zoo is subsidized 	A116N2LEI6O7HB
Can I leave a review for your product 	I do not know if you can leave a review for our product 	A3VV5FFG6GXE1S	
Is the Welsh Mountain Zoo open all year 	I do not know if the Welsh Mountain Zoo is open all year 	A9LX66EQWDRQ5
How much does it cost to ship a package 	I do not know how much it costs to ship a package	A3VVOQYMT73DSV
What is your cancellation/deposit policy 	I do not know what our cancellation/deposit policy is 	A3I9FTHSULHPYS
Where can I do my banking , now that my former branch has closed down 	I do not know where you can do your banking now that your former branch has closed down 	A3GNQDFPZALU92	
How does Beyond Unlimited work when I 'm in Mexico and/or Canada 	I do not know how Beyond Unlimited works in Mexico and/or Canada 	A2VFX3J4B1I22X
How do I set up autorenewal billing 	I do not know how to set up autorenewal billing 	AMW07CJC3OJIB
What is my account balance 	I do not know what your account balance is 	A31A4YKVSOYRVS	
Why is my account not active 	I am not able to determine why your account is not active 	A2H52PSYM32MG5	
Can My child caregiver bring my children to the Parks	I do not know if your child caregiver can bring your children to the parks	A23CTGXNDDW5LC
Does the Museum have parking 	I do not know if it has parking 	A2NI2HSU84PHJW
Is membership limited to firefighters 	I do not know if membership is limited to firefighters 	A1JBSFXMMRGSQD
Where is the nearest location where I can speak to a IRS agent regarding my business 's audit 	I do not know where the nearest IRS location is 	31D0ZWOD0ARL5CJ28O2G89PK7CR0AE
Why should you book Bucket Fillers , Inc. for a presentation 	I do not know why we should book Bucket Fillers , Inc. for a presentation 	A2VIKCIM9TZL22
if i cancel my appointment , will my deposit be refunded 	I do not know if your deposit will be refunded 	AD9O852KPYLHY	
Do you only have cars on display 	I do not know if we only have cars on display 	A325WS381BHOHH
How do I add an additional appointment located at a different campus 	I do not know how to add an additional appointment located at a different campus 	A3NZLRU95OULXB
Will there be an effort to measure this law 's effectiveness in improving patient safety and healthcare 	I do not know if there will be an effort to measure this law 's effectiveness in improving patient safety and healthcare 	A8O98QNRG9SHV
May I use images designated as CC0 in a lecture , or for other educational purposes 	I do not know if you may use images designated as CC0 in a lecture , or for other educational purposes 	A16VTK6KZ1U69H
When I try to upload my resume , I receive an error message instructing me to contact my security administrator . What do I do 	I do not know what you should do if you receive an error message instructing me to contact my security administrator when you try to upload your resume 	A3RD486RQUI2XV
How soon will my items be shipped 	I do not know how soon your items will be shipped 	AE9M4Z1NCYSDM	
I need to know your returns address so I can send back an item I received in error 	I do not know the return address 	3UQVX1UPFS9W09OYV9912R6MVOZ027
Can you tell me what the late fees will be if I have to make my payment 2 days late 	I do not know what the late fees will be 	3RDTX9JRTYTLI49H1H9PRTON98F796
How much time should we plan for a museum visit 	I do not know how much time you should plan for a museum visit 	A2NI2HSU84PHJW
The automotive parts I ordered have n't arrived to my location but the tracking says they 've been delivered . Will I be refunded for my purchase or will new parts be sent to me 	I do not know if you will be be refunded for your purchase or if new parts will be sent to you 	36KM3FWE3R43MAL41LQWYINU64L07N
How does TurboTax know which questions to ask 	I do not know how Turbo Tax know which questions to ask 	A3RD486RQUI2XV
What 's the latest I can return an item 	I do not know what the latest you can return an item is 	A31A4YKVSOYRVS	
