"Where are your dance classes held "	"I do not know where are my dance classes held"	"WQUES"
"Where can we eat "	"I do not know where you can eat"	"WQUES"
"I would like to know if you let me order two personalized pizza not on the menu"	"I do not know how to handle 'I would like to know if you let me order two personalized pizza not on the menu'"	"CANONICAL_IDK"
"Where can I find information about materials used to make a product"	"I do not know where you can find information about materials used to make a product"	"WQUES"
"When is this due "	"I do not know when this due is"	"WQUES"
"What if the weather is bad "	"I do not know what if the weather is bad"	"WQUES_SIMPLE"
"What can my account manager do for me "	"I do not know what your account manager can do for you"	"WQUES"
"How do I obtain warranty support on my AT&T product "	"I do not know how you obtain warranty support on your AT&T product"	"WQUES"
"Is state income tax withholding on supplemental wages handled differently than withholding on regular wages "	"I do not know if state income tax withholding is on supplemental wages handled differently than withholding on regular wages"	"BE_HAVE_MD_QUESTION"
"Do you rent wheelchairs , wagons , or strollers "	"I do not know if I rent wheelchairs , wagons , or strollers"	"DO_QUESTION"
"How do I know if I need help"	"I do not know how you know if you need help"	"WQUES"
"I need to change my email address before I order , how do I do this "	"I do not know how you do this"	"WQUES"
"How do I log in to Workday "	"I do not know how you log in to Workday"	"WQUES"
"When does your most recent product hit the shelves "	"I do not know when my recent product most hits the shelves"	"WQUES"
"Is help available to researchers "	"I do not know if help is available to researchers"	"BE_HAVE_MD_QUESTION"
"I need you to help me get escalated to advanced help desk for my router"	"I do not know how to handle 'I need you to help me get escalated to advanced help desk for my router'"	"CANONICAL_IDK"
"How does it help me find the right candidates "	"I do not know how it helps you find the right candidates"	"WQUES"
"How can I tell if an email really came from USAJOBS "	"I do not know how you can tell if an email really came from USAJOBS"	"WQUES"
"Is a job applicant protected under the National Labor Relations Act -LRB- NLRA -RRB- "	"I do not know if a job applicant is protected under the National Labor Relations Act -LRB- NLRA -RRB-"	"BE_HAVE_MD_QUESTION"
"I tried logging into your website and it 's telling me that my password is incorrect . When I reset my password , it still says ` incorrect password ' . Can you fix it "	"I do not know when you reset your password"	"WQUES"
"When will you be seeing more of this item "	"I do not know when I will be seeing more of this item"	"WQUES"
"Can my employer see the apps I 've installed "	"I do not know if your employer can see the apps you 've installed"	"BE_HAVE_MD_QUESTION"
"What is the difference between this insurance plan and your newest one "	"I do not know what the difference between this insurance plan and my newest one is"	"WQUES"
"Is the Museum open year-round "	"I do not know if the is Museum open year-round"	"BE_HAVE_MD_QUESTION"
"The product seems to have been damaged during shipping . What are my options "	"I do not know what your options are"	"WQUES"
"What can I do about hang up calls "	"I do not know what you can about hang up calls"	"WQUES"
"May an employer have its third-party benefits administrator -LRB- TPA -RRB- obtain a health plan identifier -LRB- HPID -RRB- for the employer 's self-insured plan "	"I do not know if an employer may have its third-party benefits administrator -LRB- TPA -RRB- obtain a health plan identifier -LRB- HPID -RRB- for the employer 's self-insured plan"	"BE_HAVE_MD_QUESTION"
"What dances can I learn in private lessons "	"I do not know what dances you can learn in private lessons"	"WQUES"
"Will you be getting a new catalog "	"I do not know if I will be getting a new catalog"	"BE_HAVE_MD_QUESTION"
"Does Intel charge run-time fees or royalties for its libraries "	"I do not know if Intel charge run-time fees or royalties for its libraries"	"DO_QUESTION"
"How can I book a tour "	"I do not know how you can book a tour"	"WQUES"
"I would like to use some of your recipes on my website . May I have permission to use your recipes "	"I do not know how to use some of my recipes on your website ."	"IMPERATIVE"
"Do you offer shipping insurance on your items "	"I do not know if I offer shipping insurance on my items"	"DO_QUESTION"
"When can I expect my invitation and how will it be sent "	"I do not know when you can expect your invitation and how will it be sent"	"WQUES"
"Can I rent Deepwood for a wedding or special event "	"I do not know if you can rent Deepwood for a wedding or special event"	"BE_HAVE_MD_QUESTION"
"How many miles per gallon does this car get "	"I do not know how many miles per gallon this car get"	"WQUES"
"Which towns does your pizza restaurant deliver to "	"I do not know which towns my pizza restaurant delivers to"	"WQUES"
"Does the no-tax-due threshold apply to the individual members of the combined group or the combined group as a whole "	"I do not know if the no-tax-due threshold applies to the individual members of the combined group or the combined group as a whole"	"DO_QUESTION"
"How do I dispute a charge on my credit card bill "	"I do not know how you dispute a charge on your credit card bill"	"WQUES"
"I have a coupon here , but I ca n't tell if it applies to everything in the store or just books . Can I use it on journals "	"I do not know if you can use it on journals"	"BE_HAVE_MD_QUESTION"
"Is there some sort of satisfaction survey I can fill out to show how helpful you 've been "	"I do not know if there is some sort of satisfaction survey you can fill out to show how helpful I 've been"	"BE_HAVE_MD_QUESTION"
"Will we have to wait"	"I do not know if you will have to wait"	"BE_HAVE_MD_QUESTION"
"What are the rental rates on your moving trucks "	"I do not know what the rental rates on my moving trucks are"	"WQUES"
"How do I go about making a return"	"I do not know how you go about making a return"	"WQUES"
"Will it stain my swimsuit "	"I do not know if it will stain your swimsuit"	"BE_HAVE_MD_QUESTION"
"What 's the status on my order "	"I do not know what the status on your order 's"	"WQUES"
"What do you guys charge for shipping "	"I do not know what do I guys charge for shipping"	"WQUES_SIMPLE"
"The tracking number says delivered but I did n't get my item , what do I do "	"I do not know what you do do"	"WQUES"
"Do you offer group discounts "	"I do not know if I offer group discounts"	"DO_QUESTION"
"I see that there are two plans that you offer . One has a higher rate per purchase but lower percentage . Can you advise me on which I should use "	"I do not know if I can advise you on which you should use"	"BE_HAVE_MD_QUESTION"
"Does MobileIron support delegation of administrative roles and functions "	"I do not know if MobileIron support delegation of administrative roles and functions"	"DO_QUESTION"
"There 's no way this package should take long to deliver , where did it go off to "	"I do not know where it went off to"	"WQUES"
"How do I cancel my monthly subscription service "	"I do not know how you cancel your monthly subscription service"	"WQUES"
"How can I get in contact with my teacher"	"I do not know how you can get in contact with your teacher"	"WQUES"
"Can you tell me who the owner of the hardware store is "	"I do not know if I can tell you who the owner of the hardware store is"	"BE_HAVE_MD_QUESTION"
"Is there a limit to the number of applications I can submit "	"I do not know if there is a limit to the number of applications you can submit"	"BE_HAVE_MD_QUESTION"
"Where can I find class prices "	"I do not know where you can find class prices"	"WQUES"
"I want to have my scheduled pickup come a week later instead of tomorrow , I have too much going on"	"I do not know if your scheduled pickup have come a week later instead of tomorrow , you have too much going on"	"BE_HAVE_MD_QUESTION"
"I need to call my sons school , Can you give me the number "	"I do not know how to call your sons"	"IMPERATIVE"
"When responding to a charge by the Equal Employment Opportunity Commission -LRB- EEOC -RRB- or a state fair employment agency , should an employer provide its entire handbook or full policies in support of its position "	"I do not know when responding to a charge by the Equal Employment Opportunity Commission -LRB- EEOC -RRB- or a state fair employment agency an employer , should provide its entire handbook or full policies in support of its position"	"WQUES"
"What is HIPAA "	"I do not know what HIPAA is"	"WQUES"
"Are the green grapes the best"	"I do not know if the are green grapes the best"	"BE_HAVE_MD_QUESTION"
"Can you help me order this as a gift for my grandma "	"I do not know if I can help you order this as a gift for your grandma"	"BE_HAVE_MD_QUESTION"
"What is Beiersdorf 's attitude regarding sustainability "	"I do not know what Beiersdorf 's attitude regarding sustainability is"	"WQUES"
"Can you tell me if you have waist sizes for men above 46 "	"I do not know if I can tell you if I have waist sizes for men above 46"	"BE_HAVE_MD_QUESTION"
"Do you accept Discover card "	"I do not know if I accept Discover card"	"DO_QUESTION"
"How do I select vendors for my event "	"I do not know how do you select vendors for your event"	"WQUES_SIMPLE"
"I forgot to cancel my trial subscription but no longer want this service , is their anyway to reverse these charges "	"I do not know if their is anyway to reverse these charges"	"BE_HAVE_MD_QUESTION"
"Can we spend the night in an RV in the Zoo 's parking area "	"I do not know if you can spend the night in an RV in the Zoo 's parking area"	"BE_HAVE_MD_QUESTION"
"How can I purchase my membership online if I prefer not to use my personal credit card information"	"I do not know how you can purchase your membership online if you prefer not to use your personal credit card information"	"WQUES"
"When can I expect to see the charge placed on my card "	"I do not know when you can expect to see the charge placed on your card"	"WQUES"
"Where did the configuration tools go "	"I do not know where the configuration tools went"	"WQUES"
"I need to renew my loan "	"I do not know how to renew your loan"	"IMPERATIVE"
"How can I follow you on Facebook "	"I do not know how you can follow me on Facebook"	"WQUES"
"What if I make a mistake "	"I do not know what you if make a mistake"	"WQUES"
"How do I change information submitted on my online application "	"I do not know how you change information submitted on your online application"	"WQUES"
"Do I have to pay an employee for unused sick time "	"I do not know if you have to pay an employee for unused sick time"	"DO_QUESTION"
"Is Kemppi active in every continent "	"I do not know if Kemppi is active in every continent"	"BE_HAVE_MD_QUESTION"
"What are random bag checks "	"I do not know what random bag checks are"	"WQUES"
"How do I make corrections to prior time sheets "	"I do not know how you make corrections to prior time sheets"	"WQUES"
"I ca n't make it in person to pick up some packages . Could I have someone else come by and collect them for me "	"I do not know if you could have someone else come by and collect them for you"	"BE_HAVE_MD_QUESTION"
"How do I add a family member to my benefits "	"I do not know how you add a family member to your benefits"	"WQUES"
"Does the Spanish version of the Form I-9 contain the same features as the English smart version "	"I do not know if the Spanish version of the Form I-9 contains the same features as the English smart version"	"DO_QUESTION"
"How can I reschedule a flight I booked ? This one I booked is n't going to be needed anymore for me "	"I do not know how you can reschedule a flight you booked"	"WQUES"
"Can I return this car at 3 PM instead of 4 PM "	"I do not know if you can return this car at 3 PM instead of 4 PM"	"BE_HAVE_MD_QUESTION"
"What do I need to do after completing booking "	"I do not know what you need to do after completing booking"	"WQUES"
"What legislation affects benefits "	"I do not know what legislation affects benefits"	"WQUES_SIMPLE"
"I need to add a spouse to my policy "	"I do not know how to add a spouse to your policy"	"IMPERATIVE"
"What qualifications stand me in good stead for finding a job in Germany "	"I do not know what qualifications stand you in good stead for finding a job in Germany"	"WQUES_SIMPLE"
"What is the price of admission "	"I do not know what the price of admission is"	"WQUES"
"How many people are attacked each year by sharks "	"I do not know how many people are attacked each year by sharks"	"WQUES_SIMPLE"
"Can you help me with my account ? It is blocked"	"I do not know if I can help you with your account"	"BE_HAVE_MD_QUESTION"
"How can I book Dorint Hotels & Resorts "	"I do not know how you can book Dorint Hotels & Resorts"	"WQUES"
"How can I check to see which of my dependents I am covering "	"I do not know how you can check to see which of your dependents you are covering"	"WQUES"
"If I am a Member , do I receive free admission to SMoCA "	"I do not know if you receive free admission to SMoCA"	"DO_QUESTION"
"What do fossils have in common with paintings , and scientific instruments with coins "	"I do not know what fossils have in common with paintings , and scientific instruments with coins"	"WQUES_SIMPLE"
"What are your payment options"	"I do not know what my payment options are"	"WQUES"
"What services do the film commissions provide "	"I do not know what services do the film commissions provide"	"WQUES_SIMPLE"
"How can I order more of that fabulous product "	"I do not know how you can order more of that fabulous product"	"WQUES"
"Do you offer any senior , student , or military discounts "	"I do not know if I offer any senior , student , or military discounts"	"DO_QUESTION"
"So this customer is trying to purchase this lamp but it does n't have a UPC code on it , do I go to the back and find another one just like it to scan "	"I do not know if you go to the back and find another one just like it to scan"	"DO_QUESTION"
"Do you walk my dog with other people 's dogs "	"I do not know if I walk your dog with other people 's dogs"	"DO_QUESTION"
"Can I park my car at the Miffy Museum "	"I do not know if you can park your car at the Miffy Museum"	"BE_HAVE_MD_QUESTION"
"Is there a place to eat in the museum "	"I do not know if there is a place to eat in the museum"	"BE_HAVE_MD_QUESTION"
"Please email me an application for a new account "	"I do not know how to email you an application for a new account"	"IMPERATIVE"
"What is an ASO "	"I do not know what an ASO is"	"WQUES"
"Are all downloadable images of artworks on The Met 's website suitable for publication "	"I do not know if all are downloadable images of artworks on The Met 's website suitable for publication"	"BE_HAVE_MD_QUESTION"
"Is the venue handicap and wheelchair accessible"	"I do not know if the is venue handicap and wheelchair accessible"	"BE_HAVE_MD_QUESTION"
"I submitted an application several months ago , but never heard anything back . Is there a still a chance that I could volunteer"	"I do not know how to but never heard anything"	"IMPERATIVE"
"Can we build our own HR reports "	"I do not know if you can build your own HR reports"	"BE_HAVE_MD_QUESTION"
"Can I get a discount if I order large quantities "	"I do not know if you can get a discount if you order large quantities"	"BE_HAVE_MD_QUESTION"
"If an employee is fired unexpectedly , how can the employer satisfy state law requiring the employer to pay the employee immediately "	"I do not know how the employer can satisfy state law requiring the employer to pay the employee immediately"	"WQUES"
"What if the database does not contain the name of the person I am looking for "	"I do not know what the database if not contains the name of the person you are looking for"	"WQUES"
"Can you please check if the item ingredients are the same as the previous version "	"I do not know if I can check if the item ingredients are the same as the previous version"	"BE_HAVE_MD_QUESTION"
"I forgot my user ID and/or password , what do I do "	"I do not know your user ID and/or password , what you do you forgot password"	"WQUES"
"Do you have a museum store"	"I do not know if I have a museum store"	"DO_QUESTION"
"Was my complaint reveiwed by a manager "	"I do not know if your complaint was reveiwed by a manager"	"BE_HAVE_MD_QUESTION"
"What types of spiritual care services are available "	"I do not know what types of spiritual care services are available"	"WQUES_SIMPLE"
"Where is ' Meet the Animals ' "	"I do not know where is ' Meet the Animals '"	"WQUES_SIMPLE"
"Do you sell matcha in tea bags "	"I do not know if I sell matcha in tea bags"	"DO_QUESTION"
"How do I view my upgrade eligibility status from my device "	"I do not know how you view your upgrade eligibility status from your device"	"WQUES"
"How do I register for PACER "	"I do not know how you register for PACER"	"WQUES"
"What do I do if I think I might be having a stroke "	"I do not know what you do if you think you might be having a stroke"	"WQUES"
"If an employee resigns with two-weeks ' notice , and we tell the employee to leave prior to the end of the two-week period , are we obligated to pay the employee for the full two weeks "	"I do not know if you are obligated to pay the employee for the full two weeks"	"BE_HAVE_MD_QUESTION"
"What are the requirements for applying for a residence card , or for the issue of an address card "	"I do not know what the requirements for applying for a residence card , or for the issue of an address card are"	"WQUES"
"What will I see in the Museum "	"I do not know what you will see in the Museum"	"WQUES"
"What is a Flexible Spending Account -LRB- FSA -RRB- "	"I do not know what a Flexible Spending Account -LRB- FSA -RRB- is"	"WQUES"
"May I loan my membership card to my mother , sister , nanny , etc. "	"I do not know if you may loan your membership card to your mother , sister , nanny , etc. ."	"BE_HAVE_MD_QUESTION"
"How long does it usually take to ship this product "	"I do not know how long it usually takes to ship this product"	"WQUES"
"Does your company provide a shuttle back to the airport when I return "	"I do not know if my company provide a shuttle back to the airport when you return"	"DO_QUESTION"
"Are returns allowed even if the product is n't damaged "	"I do not know if returns are allowed even if the product is n't damaged"	"BE_HAVE_MD_QUESTION"
"How does the warranty on my product work "	"I do not know how does the warranty on your product work"	"WQUES_SIMPLE"
"Does the BioPark accept pet donations "	"I do not know if the BioPark accepts pet donations"	"DO_QUESTION"
"Do we have to change partners during group classes "	"I do not know if you have to change partners during group classes"	"DO_QUESTION"
"Does your ice cream shop offer dairy free options "	"I do not know if my ice cream shop offer dairy free options"	"DO_QUESTION"
"How can I place an order using my tax exempt number "	"I do not know how you can place an order using your tax exempt number"	"WQUES"
"How much can I save by bundling all my insurance items together "	"I do not know how much you can save by bundling all your insurance items together"	"WQUES"
"Do I get a discount if I preorder an item "	"I do not know if you get a discount if you preorder an item"	"DO_QUESTION"
"How do I renew my membership "	"I do not know how you renew your membership"	"WQUES"
"Why does the museum charge admission"	"I do not know why does the museum charge admission"	"WQUES_SIMPLE"
"I would like someone to explain the specs of the products as I am totally new to this "	"I do not know how to handle 'I would like someone to explain the specs of the products as I am totally new to this '"	"CANONICAL_IDK"
"Do you have a preferred customer program "	"I do not know if I have a preferred customer program"	"DO_QUESTION"
"Is there a group rate or a family rate "	"I do not know if there is a group rate or a family rate"	"BE_HAVE_MD_QUESTION"
"What is the minimum GRE score "	"I do not know what the minimum GRE score is"	"WQUES"
"Can I take photographs in the museum using , for example , a digital camera "	"I do not know if you can take photographs in the museum using , for example , a digital camera"	"BE_HAVE_MD_QUESTION"
"What if I do n't like the vehicle that I have a deposit for or I have purchased another vehicle "	"I do not know what you if n't like the vehicle that you have a deposit for or you have purchased another vehicle"	"WQUES"
"Can I speak to a manager "	"I do not know if you can speak to a manager"	"BE_HAVE_MD_QUESTION"
"I only have one good hand . Is the Zinger for me "	"I do not know if the Zinger is for you"	"BE_HAVE_MD_QUESTION"
"Will you accept orders to Canada "	"I do not know if I will accept orders to Canada"	"BE_HAVE_MD_QUESTION"
"I scheduled a payment through the app but I need to change the amount . Can you help me with this "	"I do not know if I can help you with this"	"BE_HAVE_MD_QUESTION"
"What are the opening times / events on at St Katherine 's Heritage Centre , Canvey Island"	"I do not know what the opening times / events on at St Katherine 's Heritage Centre , Canvey Island are"	"WQUES"
"Do you have any free , or donation based hours "	"I do not know if I have any free , or donation based hours"	"DO_QUESTION"
"What kinds of research materials are available at the Library "	"I do not know what kinds of research materials are available at the Library"	"WQUES_SIMPLE"
"Q -- is the entire museum accessible to disabled visitors"	"I do not know how to handle 'Q -- is the entire museum accessible to disabled visitors'"	"CANONICAL_IDK"
"Can Cardio Dance really work as a gym replacement "	"I do not know if Cardio Dance can really work as a gym replacement"	"BE_HAVE_MD_QUESTION"
"What 's included in the cost of the course "	"I do not know what 's included in the cost of the course"	"WQUES_SIMPLE"
"Do I have to inform you if in my group there are children under 6 years of age "	"I do not know if you have to inform me if in your group there are children under 6 years of age"	"DO_QUESTION"
"What does ' Use Your Lid ' Mean "	"I do not know what does ' Use my Lid ' Mean"	"WQUES_SIMPLE"
"What type of attention can my child expect to get while in class "	"I do not know what type of attention your child can expect to get while in class"	"WQUES"
"Do I have to sign a contract to have your service "	"I do not know if you have to sign a contract to have my service"	"DO_QUESTION"
"May an employer make up for a wage overpayment by paying the employee less in the next wage payment "	"I do not know if an employer may make up for a wage overpayment by paying the employee less in the next wage payment"	"BE_HAVE_MD_QUESTION"
"Are there guided tours of the Fashion Museum "	"I do not know if there guided tours are of the Fashion Museum"	"BE_HAVE_MD_QUESTION"
"Will I be charged for my car reservation in advance "	"I do not know if you will be charged for your car reservation in advance"	"BE_HAVE_MD_QUESTION"
"How can an employer minimize the risk of family responsibility discrimination claims "	"I do not know how an employer can minimize the risk of family responsibility discrimination claims"	"WQUES"
"Can I confirm my flight over the phone "	"I do not know if you can confirm your flight over the phone"	"BE_HAVE_MD_QUESTION"
"I already placed an order , can I add to it "	"I do not know if you can add to it"	"BE_HAVE_MD_QUESTION"
"What is the purpose of the GT Key "	"I do not know what the purpose of the GT Key is"	"WQUES"
"When will you get this item back in stock "	"I do not know when I will get this item back in stock"	"WQUES"
"How are levels of classes and teams chosen "	"I do not know how levels of classes and teams are chosen"	"WQUES"
"Can you tell me where my order is "	"I do not know if I can tell you where your order is"	"BE_HAVE_MD_QUESTION"
"Your items are made in any number of countries , can I specifiy the country of origin I want my item to be from "	"I do not know how to my items are made in any number of"	"IMPERATIVE"
"It says my package was lost in transit . When can I receive my refund "	"I do not know when you can receive your refund"	"WQUES"
"Can we bring outside food into the Museum "	"I do not know if you can bring outside food into the Museum"	"BE_HAVE_MD_QUESTION"
"Will my information be secure with your company"	"I do not know if your information will be secure with my company"	"BE_HAVE_MD_QUESTION"
"When must an employer include the fair market value of an employee 's personal use of a company-provided cell phone in the employee 's taxable income "	"I do not know when an employer must include the fair market value of an employee 's personal use of a company-provided cell phone in the employee 's taxable income"	"WQUES"
"Is there is a way to limit an individual 's data use with The Verizon Plan "	"I do not know if there is is a way to limit an individual 's data use with The Verizon Plan"	"BE_HAVE_MD_QUESTION"
"I lost my pass and need a replacement . What should I do"	"I do not know what you should do"	"WQUES"
"I was supposed to get a certificate of authentication along with my painting , but it never came . Are you guys able to send me an official one ? If not I will need to return this work of art "	"I do not know how to you were supposed to get a certificate of authentication along with your"	"IMPERATIVE"
"When will the next drop shipment arrive for my company "	"I do not know when the next drop shipment will arrive for your company"	"WQUES"
"I 'd like to upload some documents to my account but I 'm not sure how . Can you tell me "	"I do not know if I can tell you"	"BE_HAVE_MD_QUESTION"
"Where are the best places to go shopping in London "	"I do not know where the best places to go shopping in London are"	"WQUES"
"What are the benefits of Family Membership "	"I do not know what the benefits of Family Membership are"	"WQUES"
"Is it possible to get the professional diploma which I obtained abroad recognised "	"I do not know if it is possible to get the professional diploma which you obtained abroad recognised"	"BE_HAVE_MD_QUESTION"
"How do I contact the Office of Graduate Studies "	"I do not know how you contact the Office of Graduate Studies"	"WQUES"
"After I have applied online , how can I contact a hiring manager or a recruiter "	"I do not know how you After you have applied online , can contact a hiring manager or a recruiter"	"WQUES"
"How can we book our school group or birthday party "	"I do not know how you can book your school group or birthday party"	"WQUES"
"Can I pay for my program reservation on account "	"I do not know if you can pay for your program reservation on account"	"BE_HAVE_MD_QUESTION"
"Do you place an incidental hold on my credit card when I check in"	"I do not know if I place an incidental hold on your credit card when you check in"	"DO_QUESTION"
"Can I make changes to my reservation after I have purchased it "	"I do not know if you can make changes to your reservation after you have purchased it"	"BE_HAVE_MD_QUESTION"
"I do n't know what shops are in my area that can fix my car can you help me look up a couple and provide me their phone numbers "	"I do not know what shops are in your area that can fix your car you n't know can I help you look up a couple and provide you their phone numbers"	"WQUES"
"Can visitors park in the streets around the Zoo "	"I do not know if visitors can park in the streets around the Zoo"	"BE_HAVE_MD_QUESTION"
"I made a online purchase a few minutes ago but did not get a confirmation email . Would you be able to track my order and re-send that email to me "	"I do not know if I would be able to track your order and re-send that email to you"	"BE_HAVE_MD_QUESTION"
"How can I update my information online "	"I do not know how you can update your information online"	"WQUES"
"Can you change my shipping from expedited to standard "	"I do not know if I can change your shipping from expedited to standard"	"BE_HAVE_MD_QUESTION"
"Can I pay by check or money order "	"I do not know if you can pay by check or money order"	"BE_HAVE_MD_QUESTION"
"Where can I find my XFINITY username and password "	"I do not know where you can find your XFINITY username and password"	"WQUES"
"Can I order tickets by phone or online "	"I do not know if you can order tickets by phone or online"	"BE_HAVE_MD_QUESTION"
"Do you guys have a mobile app "	"I do not know if I guys have a mobile app"	"DO_QUESTION"
"What is the capacity for an event "	"I do not know what the capacity for an event is"	"WQUES"
"Are your products ethically sourced "	"I do not know if my products are ethically sourced"	"BE_HAVE_MD_QUESTION"
"What English language qualifications do I need "	"I do not know what English language qualifications you need"	"WQUES"
"Is e-cigarette use protected by state laws prohibiting discrimination against employees for engaging in legal off-duty activities "	"I do not know if e-cigarette use is protected by state laws prohibiting discrimination against employees for engaging in legal off-duty activities"	"BE_HAVE_MD_QUESTION"
"I have a museum card . Do I still need to make a reservation "	"I do not know if you still need to make a reservation"	"DO_QUESTION"
"I purchased an airline ticket to Hawaii and my flight has been canceled due to a Hurricane heading there . How can I reschedule my flight "	"I do not know how you can reschedule your flight"	"WQUES"
"Has the museum opened "	"I do not know if the museum has opened"	"BE_HAVE_MD_QUESTION"
"I would like to apply for your store card "	"I do not know how to apply for my store card"	"IMPERATIVE"
"Can I access my car once in the Zoo "	"I do not know if you can access your car once in the Zoo"	"BE_HAVE_MD_QUESTION"
"When will you be offering more of this item "	"I do not know when I will be offering more of this item"	"WQUES"
"Do you hire out wheelchairs , mobility scooters or pushchairs "	"I do not know if I hire out wheelchairs , mobility scooters or pushchairs"	"DO_QUESTION"
"Will I get notification 24 hours in advance about my appointment via text message"	"I do not know if you will get notification 24 hours in advance about your appointment via text message"	"BE_HAVE_MD_QUESTION"
"How often should I use Wag "	"I do not know how often you should use Wag"	"WQUES"
"What is the latest date that I can arrive in Ireland with my Visa "	"I do not know what the latest date that you can arrive in Ireland with your Visa is"	"WQUES"
"How do I remove an ineligible dependent who does not meet the eligibility definition "	"I do not know how you remove an ineligible dependent who does not meet the eligibility definition"	"WQUES"
"Can I bring a pet "	"I do not know if you can bring a pet"	"BE_HAVE_MD_QUESTION"
"I returned a package but it has n't been credited to my account yet . Can you tell whether it was done "	"I do not know if I can tell whether it was done"	"BE_HAVE_MD_QUESTION"
"Do I have flood insurance ? If so , can I file a claim ? If not , can I get some for yesterday "	"I do not know if you have flood insurance"	"DO_QUESTION"
"I 'm a member of a museum that offers NARM reciprocity . What are my benefits at M * AR "	"I do not know what your benefits at M * AR are"	"WQUES"
"What is the smoking policy at the Zoo "	"I do not know what the smoking policy at the Zoo is"	"WQUES"
"Is there an early departure fee "	"I do not know if there is an early departure fee"	"BE_HAVE_MD_QUESTION"
"What are my payment options "	"I do not know what your payment options are"	"WQUES"
"How can I track orders Shipped by Newegg "	"I do not know how you can track orders Shipped by Newegg"	"WQUES"
"What is the volunteer commitment "	"I do not know what the volunteer commitment is"	"WQUES"
"I would like to get an invoice sent along with my order "	"I do not know how to get an invoice sent along with your order"	"IMPERATIVE"
"How does brown sugar differ from white sugar "	"I do not know how brown sugar differs from white sugar"	"WQUES_SIMPLE"
"Are there security features for additional users "	"I do not know if there are security features for additional users"	"BE_HAVE_MD_QUESTION"
"How large are class sizes "	"I do not know how large class sizes are"	"WQUES"
"Can I return this to any store "	"I do not know if you can return this to any store"	"BE_HAVE_MD_QUESTION"
"Can I exchange items for store credit"	"I do not know if you can exchange items for store credit"	"BE_HAVE_MD_QUESTION"
"Is the use of virtual credit cards for health care claim payments covered by HIPAA transactions requirements "	"I do not know if the use is of virtual credit cards for health care claim payments covered by HIPAA transactions requirements"	"BE_HAVE_MD_QUESTION"
"Does your hotel offer free airport shuttle service "	"I do not know if my hotel offer free airport shuttle service"	"DO_QUESTION"
"I need to correct the spelling of my name on my account "	"I do not know how to correct the spelling of your name on your account"	"IMPERATIVE"
"I need help with my cart"	"I do not know how to help with your cart"	"IMPERATIVE"
"If I ordered an item online can I return it in store"	"I do not know if you can return it in store"	"BE_HAVE_MD_QUESTION"
"I 'm new to the area . Can you send me a list of local restaurants "	"I do not know if I can send you a list of local restaurants"	"BE_HAVE_MD_QUESTION"
"When do I need to provide my financial statement "	"I do not know when you need to provide your financial statement"	"WQUES"
"My question is about my current premium . I noticed that I can actually pay a lower premium if I switch to a dual vehicle policy , is that right "	"I do not know if that is right"	"BE_HAVE_MD_QUESTION"
"When will this item be back in stock "	"I do not know when will this item be back in stock"	"WQUES_SIMPLE"
"How do I get census records "	"I do not know how you get census records"	"WQUES"
"I 'd like to order your as seen on t.v. product but I do not have a credit card . Do you accept C.O.D. orders "	"I do not know if I accept C.O.D. orders"	"DO_QUESTION"
"Do I have to print my tickets "	"I do not know if you have to print your tickets"	"DO_QUESTION"
"How do I purchase tickets online "	"I do not know how you purchase tickets online"	"WQUES"
"I 'm a classically trained dancer , can I take an advanced/challenging class"	"I do not know how to you are a classically trained"	"IMPERATIVE"
"How can I find a physical store location "	"I do not know how you can find a physical store location"	"WQUES"
"Could you please check on the status of my order "	"I do not know if I could check on the status of your order"	"BE_HAVE_MD_QUESTION"
"Are mashed potatoes a real pizza topping "	"I do not know how to are mashed potatoes a real pizza topping"	"IMPERATIVE"
"My child got on my computer and bought something that I do n't want , I need to cancel this order "	"I do not know how to cancel this order"	"IMPERATIVE"
"When will a new tour open "	"I do not know when will a new tour open"	"WQUES_SIMPLE"
"Can I get the status of my order "	"I do not know if you can get the status of your order"	"BE_HAVE_MD_QUESTION"
"Will we need to purchase dancing shoes"	"I do not know if you will need to purchase dancing shoes"	"BE_HAVE_MD_QUESTION"
"Can my bill due date be extended by two weeks "	"I do not know if your bill due date can be extended by two weeks"	"BE_HAVE_MD_QUESTION"
"What Is Fool 's Gold "	"I do not know what Fool 's Gold Is"	"WQUES"
"Where do I go to report for jury duty "	"I do not know where you go to report for jury duty"	"WQUES"
"How does one change the delivery schedule for an item they ordered ? I wo n't be there to pick it up unfortunately "	"I do not know how one change the delivery schedule for an item they ordered does"	"WQUES"
"How often do you update your physical catalog "	"I do not know how often I update my physical catalog"	"WQUES"
"Are you the National Park Service "	"I do not know if I am the National Park Service"	"BE_HAVE_MD_QUESTION"
"How secure is my data with HeavenHR "	"I do not know how secure your data with HeavenHR is"	"WQUES"
"Is the hardware to assemble the kit included "	"I do not know if the hardware is to assemble the kit included"	"BE_HAVE_MD_QUESTION"
"What will happen after I apply "	"I do not know what will happen after you apply"	"WSUBJ"
"Can Dealer Teamwork update the specials for me "	"I do not know if dealer Teamwork can update the specials for you"	"BE_HAVE_MD_QUESTION"
"What is group therapy like"	"I do not know what group therapy like is"	"WQUES"
"When do hospitals have to meet the Medicaid meaningful use requirements "	"I do not know when hospitals have to meet the Medicaid meaningful use requirements"	"WQUES"
"I want this invoice sent to my fax "	"I do not know how to this invoice sent to your fax"	"IMPERATIVE"
"Can I have an independent inspection done on the car before I buy it "	"I do not know if you can have an independent inspection done on the car before you buy it"	"BE_HAVE_MD_QUESTION"
"I made a mistake in ordering some items and want to get a refund on the purchase I made . Can you guide me through this "	"I do not know if I can guide you through this"	"BE_HAVE_MD_QUESTION"
"What if you 're rental car is n't filled when I pick it up "	"I do not know when you pick it up"	"WQUES"
"If I buy a ticket online but I decide not to go , can I give it to another person"	"I do not know if you can give it to another person"	"BE_HAVE_MD_QUESTION"
"I am a Member . Can I park for free "	"I do not know if you can park for free"	"BE_HAVE_MD_QUESTION"
"I see movies and TV shows available on my retailer 's website for purchase that are not listed as UltraViolet . Why "	"I do not know movies and TV shows available on your retailer 's website for purchase that are not listed as UltraViolet you see ."	"WQUES"
"Where are the butterflies "	"I do not know where the butterflies are"	"WQUES"
"What is the temperature going to be like during my stay "	"I do not know what the temperature going to be like during your stay is"	"WQUES"
"Can you help me with my class project "	"I do not know if I can help you with your class project"	"BE_HAVE_MD_QUESTION"
"I would like to place an order , but the website does n't seem to be working properly right now "	"I do not know how to place an"	"IMPERATIVE"
"Where can I confirm my ANA SKY COIN balance "	"I do not know where you can confirm your ANA SKY COIN balance"	"WQUES"
"How do I get on your mailing list "	"I do not know how you get on my mailing list"	"WQUES"
"How many coupons are accepted per order "	"I do not know how many coupons are accepted per order"	"WQUES_SIMPLE"
"I received a call from this number , is this the car place ? I need a replacement part "	"I do not know if this is the car"	"BE_HAVE_MD_QUESTION"
"I am trying to take an assessment online but the website does not work , can i do it over the phone with a agent "	"I do not know if you can do it over the phone with a agent"	"BE_HAVE_MD_QUESTION"
"My order says it was delivered but I never received it "	"I do not know how to handle 'My order says it was delivered but I never received it '"	"CANONICAL_IDK"
"How recent is your data "	"I do not know how recent my data is"	"WQUES"
"What if some of my employees do n't have access to the internet "	"I do not know what some of your employees if n't have access to the internet"	"WQUES"
"How do I report the sale of my second residence "	"I do not know how you report the sale of your second residence"	"WQUES"
"Does your house insurance cover termite damage"	"I do not know if my house insurance cover termite damage"	"DO_QUESTION"
"What items of clothing qualify "	"I do not know what items of clothing qualify"	"WQUES_SIMPLE"
"My electronic tax return keeps getting rejected because a dependent 's social security number is used more than once on one return or is used on another return . What should I do "	"I do not know what you should do"	"WQUES"
"Is the carousel operating today "	"I do not know if the carousel operating is today"	"BE_HAVE_MD_QUESTION"
"Where do I call to help me find a doctor nearby "	"I do not know where you call to help you find a doctor nearby"	"WQUES"
"If I do n't have a diverse pool of applicants what can I do "	"I do not know what you can do"	"WQUES"
"Are there age restrictions "	"I do not know if there are age restrictions"	"BE_HAVE_MD_QUESTION"
"Can you check on the status of my rebate "	"I do not know if I can check on the status of your rebate"	"BE_HAVE_MD_QUESTION"
"How should a retailer handle items normally sold as a unit "	"I do not know how a retailer should handle items normally sold as a unit"	"WQUES"
"Are there any federal Indian reservations in Alaska "	"I do not know if there are any federal Indian reservations in Alaska"	"BE_HAVE_MD_QUESTION"
"Can someone from outside of UCSB -LRB- including other UC campuses -RRB- donate vacation time to an eligible employee through the Catastrophic Leave Sharing Program "	"I do not know if someone can from outside of UCSB -LRB- including other UC campuses -RRB- donate vacation time to an eligible employee through the Catastrophic Leave Sharing Program"	"BE_HAVE_MD_QUESTION"
"Will we be able to log into Workday through the college homepage "	"I do not know if you will be able to log into Workday through the college homepage"	"BE_HAVE_MD_QUESTION"
"Does BAMPFA have a lost and found "	"I do not know if BAMPFA have a lost and found"	"DO_QUESTION"
"My order has not arrived yet"	"I do not know how to your order has not arrived yet"	"IMPERATIVE"
"Why does my hamster need an exercise wheel "	"I do not know why your hamster needs an exercise wheel"	"WQUES"
"Are there any fees associated with backdating my account under The Verizon Plan "	"I do not know if there are any fees associated with backdating your account under The Verizon Plan"	"BE_HAVE_MD_QUESTION"
"Can I leave the site and come back in if I 'm a VIP or Platinum customer "	"I do not know if you can leave the site and come back in if you are a VIP or Platinum customer"	"BE_HAVE_MD_QUESTION"
"What color does that blender come in ? Can I choose "	"I do not know that blender What color comes in"	"WQUES"
"When is it necessary to have the place of accommodation notified , and how it is done "	"I do not know when it is necessary to have the place of accommodation notified , and how it is done"	"WQUES"
"Can I reset my pin "	"I do not know if you can reset your pin"	"BE_HAVE_MD_QUESTION"
"How can I , as an employee , prepare myself to conduct a performance appraisal "	"I do not know how you can , as an employee , prepare yourself to conduct a performance appraisal"	"WQUES"
"Do employees say negative things in Know Your Company "	"I do not know if employees say negative things in Know my Company"	"DO_QUESTION"
"My name is spelled wrong . Are you able to fix it "	"I do not know how to your name is spelled wrong ."	"IMPERATIVE"
"How long does it take to visit Henry Ford Museum of American Innovation "	"I do not know how long it takes to visit Henry Ford Museum of American Innovation"	"WQUES"
"How do I set up an online bridal registry "	"I do not know how you set up an online bridal registry"	"WQUES"
"What digital products do you have "	"I do not know what digital products I have"	"WQUES"
"Are only workers who are currently pregnant protected under federal law "	"I do not know if only are workers who are currently pregnant protected under federal law"	"BE_HAVE_MD_QUESTION"
"How can I confirm that the movie or TV show I purchased has rights stored in my UltraViolet Library "	"I do not know how you can confirm that the movie or TV show you purchased has rights stored in your UltraViolet Library"	"WQUES"
"What do I do if I lost my membership card "	"I do not know what you do if you lost your membership card"	"WQUES"
"What is the phone number of your locate chain store "	"I do not know what the phone number of my locate chain store is"	"WQUES"
"Is there a paper application or a sample application "	"I do not know if there is a paper application or a sample application"	"BE_HAVE_MD_QUESTION"
"I hear there is a security interview before my flight "	"I do not know how to handle 'I hear there is a security interview before my flight '"	"CANONICAL_IDK"
"What is the Dorint Card "	"I do not know what the Dorint Card is"	"WQUES"
"How old do I have to be to gamble "	"I do not know how old you have to be to gamble"	"WQUES"
"How does one get a refund on an item that is n't functioning properly ? It 's important this works for me"	"I do not know how one get a refund on an item that is n't functioning properly"	"WQUES"
"Can I take it on the Plane "	"I do not know if you can take it on the Plane"	"BE_HAVE_MD_QUESTION"
"Are There Any Membership Fees "	"I do not know if there are Any Membership Fees"	"BE_HAVE_MD_QUESTION"
"I am vegetarian . What menu items can I eat "	"I do not know what menu items you can eat"	"WQUES"
"How long is the audition class "	"I do not know how long the audition class is"	"WQUES"
"How often do the exhibits change "	"I do not know how often the exhibits change"	"WQUES"
"Am I required to attend orientation to sign up for benefits "	"I do not know if you are required to attend orientation to sign up for benefits"	"BE_HAVE_MD_QUESTION"
"What do I do with my coat or large bag "	"I do not know what you do with your coat or large bag"	"WQUES"
"Where is the zoo located "	"I do not know where the zoo is located"	"WQUES"
"Why do you ask for my phone number when I 'm enrolling in MileagePlus "	"I do not know why I ask for your phone number when you are enrolling in MileagePlus"	"WQUES"
"I wo n't be able to pick up my order until tomorrow , but I scheduled it for pickup today . Can we change this "	"I do not know if you can change this"	"BE_HAVE_MD_QUESTION"
"What kind of activities the Museum have "	"I do not know what kind of activities the Museum have"	"WQUES"
"What is going to happen to current DACA holders "	"I do not know what is going to happen to current DACA holders"	"WSUBJ"
"My account information was added wrong to my mortgage company , can we fix this error "	"I do not know how to your account information was added wrong to your mortgage"	"IMPERATIVE"
"When can I expect my package "	"I do not know when you can expect your package"	"WQUES"
"What is the quickest , most effective way to learn to dance "	"I do not know what the quickest , effective way to learn to dance is most"	"WQUES"
"Do you have any boxes in the back that I can take home "	"I do not know if I have any boxes in the back that you can take home"	"DO_QUESTION"
"Can I get checks with this account "	"I do not know if you can get checks with this account"	"BE_HAVE_MD_QUESTION"
"Do you have guided tours "	"I do not know if I have guided tours"	"DO_QUESTION"
"How do I reach someone in another office "	"I do not know how you reach someone in another office"	"WQUES"
"Is breakfast included "	"I do not know if breakfast is included"	"BE_HAVE_MD_QUESTION"
"Are there special feeding times "	"I do not know if there are special feeding times"	"BE_HAVE_MD_QUESTION"
"Do you have any free days "	"I do not know if I have any free days"	"DO_QUESTION"
"I took pictures of Philbrook on a regular admission visit , but I would like to publish the photos now . What do I do "	"I do not know what you do"	"WQUES"
"What action should an employer take if an overpaid employee refuses to consent to the employer 's request to seek a refund of the overpaid FICA taxes "	"I do not know what action an employer should take if an overpaid employee refuses to consent to the employer 's request to seek a refund of the overpaid FICA taxes"	"WQUES"
"Do you offer digital printing on you cakes "	"I do not know if I offer digital printing on me cakes"	"DO_QUESTION"
"What specific assistance does hospice provide patients "	"I do not know what specific assistance hospice provides patients"	"WQUES_SIMPLE"
"How do I find out what 's new and get tips on using Congress.gov "	"I do not know how you find out what 's new and get tips on using Congress.gov"	"WSUBJ"
"How do I enroll in Shipped by Newegg "	"I do not know how you enroll in Shipped by Newegg"	"WQUES"
"Who is Kia "	"I do not know who Kia is"	"WQUES"
"How much will a new phone cost "	"I do not know how much will a new phone cost"	"WQUES_SIMPLE"
"What date do the ski slopes open "	"I do not know what date do the ski slopes open"	"WQUES_SIMPLE"
"I scheduled an oil change for 2 pm but need to change it to 5 pm "	"I do not know how to handle 'I scheduled an oil change for 2 pm but need to change it to 5 pm '"	"CANONICAL_IDK"
"Where will my refund go "	"I do not know where your refund will go"	"WQUES"
"What should I do if I recieved a package but do n't recognize the address or recipiant on the ship to label "	"I do not know what you should do if you recieved a package but n't recognize the address or recipiant on the ship to label"	"WQUES"
"Can Cats Cry Real Tears of Pain or Sadness "	"I do not know if cats can Cry Real Tears of Pain or Sadness"	"BE_HAVE_MD_QUESTION"
"What needs to be done to change my address associated with my online account for this company "	"I do not know what needs to be done to change your address associated with your online account for this company"	"WSUBJ"
"Can you walk me through how to reboot my POS within the next ten minutes , please "	"I do not know if I can walk you through how to reboot your POS within the next ten minutes"	"BE_HAVE_MD_QUESTION"
"I need to discuss my invoice with you "	"I do not know how to discuss your invoice with me"	"IMPERATIVE"
"I ordered 2 copies of photos online . I had received only 1 copy of photos . Could you send it the rest "	"I do not know if I could send it the rest"	"BE_HAVE_MD_QUESTION"
"Hello , May I speak to someone in customer service "	"I do not know how to handle 'Hello , May I speak to someone in customer service '"	"CANONICAL_IDK"
"When will I receive my annual pass "	"I do not know when you will receive your annual pass"	"WQUES"
"Do I need to inform HR when I marry or have a child , and how does it affect my benefits if I forget "	"I do not know if you need to inform HR when you marry or have a child , and how does it affect your benefits if you forget"	"DO_QUESTION"
"Why is a Hospitalist Caring for me Instead of my Regular Doctor "	"I do not know why is a Hospitalist Caring for you Instead of your Regular Doctor"	"WSUBJ"
"Can I check in if the booking is under someone else 's name "	"I do not know if you can check in if the booking is under someone else 's name"	"BE_HAVE_MD_QUESTION"
"Should an employer seek a refund from the IRS of overwithheld income taxes due to a prior-year wage overpayment "	"I do not know if an employer should seek a refund from the IRS of overwithheld income taxes due to a prior-year wage overpayment"	"BE_HAVE_MD_QUESTION"
"How often should employees enter their worked hours into their Workday timesheet "	"I do not know how often employees should enter their worked hours into their Workday timesheet"	"WQUES"
"We are a family group of 5 wanting entrance tickets to the Vatican . 3 are over 18 and 2 under . It is unclear whether I should book for the under 18 separately as although I mentioned all 5 names in the group space , the quoted price seems to be only for the over 18 . Pls advise"	"I do not know how to handle 'We are a family group of 5 wanting entrance tickets to the Vatican . 3 are over 18 and 2 under . It is unclear whether I should book for the under 18 separately as although I mentioned all 5 names in the group space , the quoted price seems to be only for the over 18 . Pls advise'"	"CANONICAL_IDK"
"What is the length of time that a California employee must have worked before the employee is eligible for California pregnancy disability leave "	"I do not know what the length of time that a California employee must have worked before the employee is eligible for California pregnancy disability leave is"	"WQUES"
"Is there anyway to get a new copy of the book I just ordered ? The first and last 20 pages are reversed "	"I do not know if there is anyway to get a new copy of the book you just ordered"	"BE_HAVE_MD_QUESTION"
"I place an order three weeks ago and still have not received it . Can you check to find out why "	"I do not know if I can check to find out why"	"BE_HAVE_MD_QUESTION"
"Why ca n't I microwave my honey bottle "	"I do not know why ca n't you microwave your honey bottle"	"WQUES_SIMPLE"
"Can I change which store I will pick my order up from "	"I do not know if you can change which store you will pick your order up from"	"BE_HAVE_MD_QUESTION"
"How long will the balloons stay inflated "	"I do not know how long the balloons will stay inflated"	"WQUES"
"Is there any overnight camping "	"I do not know if there is any overnight camping"	"BE_HAVE_MD_QUESTION"
"Is there a law that requires food labels to list ingredients that commonly cause food allergies "	"I do not know if there is a law that requires food labels to list ingredients that commonly cause food allergies"	"BE_HAVE_MD_QUESTION"
"Will my Employment Consultant/Recruiter inform me if I do n't have a diverse applicant pool "	"I do not know if your Employment Consultant/Recruiter will inform you if you n't have a diverse applicant pool"	"BE_HAVE_MD_QUESTION"
"What exactly are the balloons made out of "	"I do not know what the balloons exactly are made out of"	"WQUES"
"When is it considered too late to cancel my request "	"I do not know when it is considered too late to cancel your request"	"WQUES"
"Please cancel my order if it has not shipped yet "	"I do not know how to cancel your order if it has not shipped yet"	"IMPERATIVE"
"How often do you restock supplies "	"I do not know how often I restock supplies"	"WQUES"
"How do I access My Verizon from my mobile device "	"I do not know how do you access your Verizon from your mobile device"	"WQUES_SIMPLE"
"Could you help me discontinue my service "	"I do not know if I could help you discontinue your service"	"BE_HAVE_MD_QUESTION"
"Do you offer any birthday party packages "	"I do not know if I offer any birthday party packages"	"DO_QUESTION"
"Can I transfer my membership "	"I do not know if you can transfer your membership"	"BE_HAVE_MD_QUESTION"
"Can I talk to someone about cancelling or suspending my service "	"I do not know if you can talk to someone about cancelling or suspending your service"	"BE_HAVE_MD_QUESTION"
"What is the condition of your vehicles "	"I do not know what the condition of my vehicles is"	"WQUES"
"I 'm trying to find a good hearing aid for my mother but have no idea where to start looking for information . Help "	"I do not know you have no idea where to start looking for information you are trying to find a good hearing aid for your mother but ."	"WQUES"
"Could I receive a partial discount on my recently purchased item that came with a minor defect "	"I do not know if you could receive a partial discount on your recently purchased item that came with a minor defect"	"BE_HAVE_MD_QUESTION"
"Hi I received a call from a fraudster showing your company 's number . How do I know it is not on of your agents next time "	"I do not know how you know it is not on of my agents next time"	"WQUES"
"I booked on a website other than the hotel website and I need to make a change to my reservation . How do I do this "	"I do not know how you do this"	"WQUES"
"Are there any taxis on Naoshima "	"I do not know if there are any taxis on Naoshima"	"BE_HAVE_MD_QUESTION"
"When do package dimensions determine my rates "	"I do not know when package dimensions determine your rates"	"WQUES"
"How does TurboTax work "	"I do not know how TurboTax work does"	"WQUES"
"If I 'm an AACA Club Member do I need my card "	"I do not know how to handle 'If I 'm an AACA Club Member do I need my card '"	"CANONICAL_IDK"
"Can I buy a 50 pound block of shrimp"	"I do not know if you can buy a 50 pound block of shrimp"	"BE_HAVE_MD_QUESTION"
"I need to know my routing and account number "	"I do not know how to handle 'I need to know my routing and account number '"	"CANONICAL_IDK"
"Do I have any upgrades available "	"I do not know if you have any upgrades available"	"DO_QUESTION"
"If an employer provides computers to employees , does the employer need to notify employees before searching the computer "	"I do not know if the employer need to notify employees before searching the computer"	"DO_QUESTION"
"How many animals are at the Maryland Zoo "	"I do not know how many animals are at the Maryland Zoo"	"WQUES_SIMPLE"
"Where do I find my customer number "	"I do not know where you find your customer number"	"WQUES"
"Should self-employment taxes be paid quarterly or yearly "	"I do not know if self-employment taxes should be paid quarterly or yearly"	"BE_HAVE_MD_QUESTION"
"How specific do I need to be on employment dates on the application "	"I do not know how specific you need to be on employment dates on the application"	"WQUES"
"What is the AMC Museum Foundation , Inc. . "	"I do not know what the AMC Museum Foundation , Inc. is"	"WQUES"
"What if my child is traveling alone "	"I do not know what your child if is traveling alone"	"WQUES"
"What can I call my company "	"I do not know what you can call your company"	"WQUES"
"Does DivX video work only with a DivX VOD server "	"I do not know if divx video work only with a DivX VOD server"	"DO_QUESTION"
"What if my membership has expired "	"I do not know what your membership if has expired"	"WQUES"
"How would your curriculum for a machine learning beginner look like "	"I do not know how would my curriculum for a machine learning beginner look like"	"WQUES_SIMPLE"
"How do I redeem my benefit of free guest All Museums passes "	"I do not know how you redeem your benefit of free guest All Museums"	"WQUES"
"Have there been any changes to my contract as a result of this merger "	"I do not know if there have been any changes to your contract as a result of this merger"	"BE_HAVE_MD_QUESTION"
"How far in advance can I reserve my backcountry spots "	"I do not know how far in advance you can reserve your backcountry spots"	"WQUES"
"What are guest passes "	"I do not know what guest passes are"	"WQUES"
"I am going to be moving in a few weeks and I need to update my address . Can I do that with the mobile app "	"I do not know if you can do that with the mobile app"	"BE_HAVE_MD_QUESTION"
"Can we watch class "	"I do not know if you can watch class"	"BE_HAVE_MD_QUESTION"
"What is the best way to protect an employee from identity theft "	"I do not know what the best way to protect an employee from identity theft is"	"WQUES"
"What is the maximum number of visitors to bring for a group tour "	"I do not know what the maximum number of visitors to bring for a group tour is"	"WQUES"
"What video presentations are available "	"I do not know what video presentations are available"	"WQUES_SIMPLE"
"What if I entered the wrong delivery address"	"I do not know what you if entered the wrong delivery address"	"WQUES"
"Do I have to come all the way back to the Backcountry Information Center if I do not wish to begin my backcountry trip until after my stay at one of the campgrounds "	"I do not know if you have to come all the way back to the Backcountry Information Center if you do not wish to begin your backcountry trip until after your stay at one of the campgrounds"	"DO_QUESTION"
"What is the DMV road test "	"I do not know what the DMV road test is"	"WQUES"
"Can my child try out or observe a class before signing up "	"I do not know if your child can try out or observe a class before signing up"	"BE_HAVE_MD_QUESTION"
"When is the gift shop open "	"I do not know when the gift shop is open"	"WQUES"
"I would like to change my avatar . How can I upload a new one , and what image format and size are required "	"I do not know how to change your avatar ."	"IMPERATIVE"
"Can DACA recipients whose valid EAD is lost , stolen or destroyed request a new EAD during the phase out "	"I do not know if daca recipients whose can valid EAD is lost , stolen or destroyed request a new EAD during the phase out"	"BE_HAVE_MD_QUESTION"
"I received a package but it 's not at all what I ordered in the first place . How do I get a refund "	"I do not know what you ordered in the first place"	"WQUES"
"Can we bring pets to the Zoo "	"I do not know if you can bring pets to the Zoo"	"BE_HAVE_MD_QUESTION"
"Whenever I access Hulu , it says the videos are unavailable right now "	"I do not know how to Whenever you access"	"IMPERATIVE"
"How can I become a member "	"I do not know how you can become a member"	"WQUES"
"Can you tell me when my order will be shipped "	"I do not know if I can tell you when your order will be shipped"	"BE_HAVE_MD_QUESTION"
"My brand new puppy apparently has a thing for power cords and just chewed through mine . Do I have to order a new one on-line or can I get one in a store "	"I do not know if you have to order a new one on-line or can you get one in a store"	"DO_QUESTION"
"If I do n't like the product am I able to return it "	"I do not know how to handle 'If I do n't like the product am I able to return it '"	"CANONICAL_IDK"
"If my order arrives broken do you issue a refund "	"I do not know how to handle 'If my order arrives broken do you issue a refund '"	"CANONICAL_IDK"
"Is the Museum appropriate for children and school groups "	"I do not know if the Museum is appropriate for children and school groups"	"BE_HAVE_MD_QUESTION"
"Where is your recital held and how much are tickets "	"I do not know my recital how much are my recital held and tickets"	"WQUES"
"What is your policy regarding the donation of complimentary tickets "	"I do not know what my policy regarding the donation of complimentary tickets is"	"WQUES"
"What type of wood is best for kitchen floors "	"I do not know what type of wood is best for kitchen floors"	"WQUES_SIMPLE"
"What is the Superior Court "	"I do not know what the Superior Court is"	"WQUES"
"I 'd like to rent the car for the long weekend - does the deal start on Friday or Saturday "	"I do not know how to rent the car for the long"	"IMPERATIVE"
"What are Veteran 's Credits and who is eligible for them "	"I do not know what are Veteran 's Credits and who is eligible for them"	"WSUBJ"
"Are pets welcome in the zoo "	"I do not know if pets are welcome in the zoo"	"BE_HAVE_MD_QUESTION"
"May an employer ask on an application form if a candidate has any arrests or criminal convictions "	"I do not know if an employer may ask on an application form if a candidate has any arrests or criminal convictions"	"BE_HAVE_MD_QUESTION"
"Can I pay for this package using multiple credit cards"	"I do not know if you can pay for this package using multiple credit cards"	"BE_HAVE_MD_QUESTION"
"There is no showroom where I live . Can I still purchase a system and meet with a design consultant "	"I do not know where you live"	"WQUES"
"Can I get another check book please "	"I do not know if you can get another check book"	"BE_HAVE_MD_QUESTION"
"Will the amount of the award change "	"I do not know if the will amount of the award change"	"BE_HAVE_MD_QUESTION"
"I want to begin study this year / I want to begin study late next year . When do I need to apply "	"I do not know how to begin study this"	"IMPERATIVE"
"If I Need Help in Making an End-of-Life Decision , Whom Do I See "	"I do not know in Making an End-of-Life Decision , Whom you See you If Need Help"	"WQUES"
"Does my shipping include insurance "	"I do not know if your shipping includes insurance"	"DO_QUESTION"
"I had an appointment for a repair to my car tomorrow but I ca n't get off work , any way we can reschedule "	"I do not know how to handle 'I had an appointment for a repair to my car tomorrow but I ca n't get off work , any way we can reschedule '"	"CANONICAL_IDK"
"How long will it take for my account to be active "	"I do not know how long it will take for your account to be active"	"WQUES"
"I will still get service even if I live way up north "	"I do not know how to handle 'I will still get service even if I live way up north '"	"CANONICAL_IDK"
"How will Tech Data 's web site assist me in making more revenue "	"I do not know how Tech Data 's web site will assist you in making more revenue"	"WQUES"
"What has the housing market been like this year "	"I do not know what has the housing market been like this year"	"WSUBJ"
"Are all the rides free "	"I do not know if all the rides are free"	"BE_HAVE_MD_QUESTION"
"Can I transfer miles to someone else "	"I do not know if you can transfer miles to someone else"	"BE_HAVE_MD_QUESTION"
"Where will the competition be held "	"I do not know where the competition will be held"	"WQUES"
"My baby is hungry , is there a space where I can breast-feed privately "	"I do not know where you can breast-feed privately"	"WQUES"
"What if I still have questions "	"I do not know what you if still have questions"	"WQUES"
"Where can I find the latest news and information on Coca-Cola alumni "	"I do not know where you can find the latest news and information on Coca-Cola alumni"	"WQUES"
"Which campuses are impacted by the closure "	"I do not know which campuses are impacted by the closure"	"WQUES_SIMPLE"
"Do you have any special hours for holidays "	"I do not know if I have any special hours for holidays"	"DO_QUESTION"
"When can I expect my order to ship "	"I do not know when you can expect your order to ship"	"WQUES"
"What should I do if I forgot my password"	"I do not know what you should do if you forgot your password"	"WQUES"
"How do I sync my zoozil account across multiple devices"	"I do not know how do you sync your zoozil account across multiple devices"	"WQUES_SIMPLE"
"So how do I play Fantasy Movie League "	"I do not know how you play Fantasy Movie League"	"WQUES"
"What size dress did we order for my daughter"	"I do not know what size dress did you order for your daughter"	"WQUES_SIMPLE"
"Do you have any one bedroom apartments available in your complex "	"I do not know if I have any one bedroom apartments available in my complex"	"DO_QUESTION"
"Who is eligible for a Senior Pass "	"I do not know who is eligible for a Senior Pass"	"WSUBJ"
"Are you hiring "	"I do not know if I am hiring"	"BE_HAVE_MD_QUESTION"
"Can I Learn Whatever Dance I Want "	"I do not know if you can Learn Whatever Dance you Want"	"BE_HAVE_MD_QUESTION"
"Can a supplement help me lose weight "	"I do not know if a supplement can help you lose weight"	"BE_HAVE_MD_QUESTION"
"Why does n't the studio prorate for missed classes "	"I do not know why the studio n't prorates for missed classes"	"WQUES"
"This dress did not fit me it was too tight may i exchange it for a different size "	"I do not know how to handle 'This dress did not fit me it was too tight may i exchange it for a different size '"	"CANONICAL_IDK"
"What is the Department of Justice 's role with respect to the Form I-9 "	"I do not know what the Department of Justice 's role with respect to the Form I-9 is"	"WQUES"
"What will I learn "	"I do not know what you will learn"	"WQUES"
"What can I do after I have graduated "	"I do not know what you can do after you have graduated"	"WQUES"
"Where can I purchase new movies and TV shows "	"I do not know where you can purchase new movies and TV shows"	"WQUES"
"Is the do n't - dress-up thing a test "	"I do not know if the do n't - dress-up thing is a test"	"BE_HAVE_MD_QUESTION"
"How long does the Tour Take"	"I do not know how long the Tour takes"	"WQUES"
"How long does it take for a package from the US to arrive in Israel if I ship it today and priority mail "	"I do not know how long it takes for a package from the you to arrive in Israel if you ship it today and priority mail"	"WQUES"
"I can not see your e-edition online - it 's just giving me an error message and saying the content is n't available . I have an active account , so what 's going on with the access "	"I do not know you have an active account , so what 's going on with the access"	"WSUBJ"
"Could you please let me know if i will be compensated for the minor damages to my ordered product "	"I do not know if I could let you know if you will be compensated for the minor damages to your ordered product"	"BE_HAVE_MD_QUESTION"
"What educational expenses are considered to be ' current ' educational expenses "	"I do not know what educational expenses to be ' current ' educational expenses What educational expenses are considered"	"WQUES"
"Can I take pictures and video while I am in the Museum "	"I do not know if you can take pictures and video while you are in the Museum"	"BE_HAVE_MD_QUESTION"
"Will I be able to customize this laptop online if I need specific features"	"I do not know if you will be able to customize this laptop online if you need specific features"	"BE_HAVE_MD_QUESTION"
"Is the Museum appropriate for children "	"I do not know if the Museum is appropriate for children"	"BE_HAVE_MD_QUESTION"
"Can I get extra procentage of if the item is damaged "	"I do not know if you can get extra procentage of if the item is damaged"	"BE_HAVE_MD_QUESTION"
"Can you help me find a particular quotation I saw at the Museum "	"I do not know if I can help you find a particular quotation you saw at the Museum"	"BE_HAVE_MD_QUESTION"
"What if it has been 72 hours and my stay has not posted "	"I do not know what your stay has not posted"	"WQUES"
"Can I please speak to your manager "	"I do not know if you can speak to my manager"	"BE_HAVE_MD_QUESTION"
"What are the Law Enforcement Support team 's hours of operation "	"I do not know what the Law Enforcement Support team 's hours of operation are"	"WQUES"
"Do you offer free shipping "	"I do not know if I offer free shipping"	"DO_QUESTION"
"Could you check on the status of my request , the code is # 378271 "	"I do not know if I could check on the status of your request , the code is # 378271"	"BE_HAVE_MD_QUESTION"
"Where can I check on a service request online "	"I do not know where you can check on a service request online"	"WQUES"
"Do I need to print my tickets "	"I do not know if you need to print your tickets"	"DO_QUESTION"
"My product said that it has been delivered , but I never received it , and I 'm worried it may have gone missing . Is there a way that verify that it was delivered "	"I do not know if there is a way that verify that it was delivered"	"BE_HAVE_MD_QUESTION"
"Where is the nearest parking garage "	"I do not know where the nearest parking garage is"	"WQUES"
"I expect to be informed as to where my purchase is every 24 hours prior to delivery "	"I do not know you to be informed as to where your purchase is every 24 hours prior to delivery you expect"	"WQUES"
"Which browsers do you recommend "	"I do not know which browsers I recommend"	"WQUES"
"Could you please provide me with the updated W9 form for the calendar year 2018 "	"I do not know if I could provide you with the updated W9 form for the calendar year 2018"	"BE_HAVE_MD_QUESTION"
"Are there dinner and treat options available "	"I do not know if there are dinner and treat options available"	"BE_HAVE_MD_QUESTION"
"How long does it take to do a custom order "	"I do not know how long it takes to do a custom order"	"WQUES"
"Can you delay my delivery a few days "	"I do not know if I can delay your delivery a few days"	"BE_HAVE_MD_QUESTION"
"Can I claim the credit for the elderly or the permanently and totally disabled "	"I do not know if you can claim the credit for the elderly or the permanently and totally disabled"	"BE_HAVE_MD_QUESTION"
"What is your return policy for item bought online , I will get back my refund or I will have to accept store credit "	"I do not know what is my return policy for item bought online , you will get back your refund or you will have to accept store credit"	"WQUES"
"How can I learn more about my Xerox Products "	"I do not know how you can learn more about your Xerox Products"	"WQUES"
"Why Do Cats Knead "	"I do not know why Do Cats Knead"	"WQUES_SIMPLE"
"What is the earliest time I can check-in "	"I do not know what the earliest time you can check-in is"	"WQUES"
"Are there guided tours "	"I do not know if there are guided tours"	"BE_HAVE_MD_QUESTION"
"I want to place an order with Amazon , can you give me the lowest price "	"I do not know how to place an order with"	"IMPERATIVE"
"How do I address my overpayment of my Bill"	"I do not know how you address your overpayment of your Bill"	"WQUES"
"Can you reissue the receipt if I tell you my credit card number ? I lost it , but I need it for tax purpose "	"I do not know if I can reissue the receipt if you tell me your credit card number"	"BE_HAVE_MD_QUESTION"
"Are Lodge Enamel products tested for lead safety "	"I do not know if Lodge Enamel products are tested for lead safety"	"BE_HAVE_MD_QUESTION"
"Can name and subject authorities be searched in a single query "	"I do not know how to can name and subject authorities be searched in a single query"	"IMPERATIVE"
"Are Hearing Devices Available for the hearing impaired"	"I do not know if hearing Devices Available are for the hearing impaired"	"BE_HAVE_MD_QUESTION"
"Where may I nurse my child "	"I do not know where may you nurse your child"	"WQUES_SIMPLE"
"Have you ever tried this product "	"I do not know if I have ever tried this product"	"BE_HAVE_MD_QUESTION"
"My original hotel reservation was for a 2 Queen room , but we now need a 1 King room . Are any still available "	"I do not know if any are still available"	"BE_HAVE_MD_QUESTION"
"How do I plan a visit to the Memorial "	"I do not know how you plan a visit to the Memorial"	"WQUES"
"Is there a warranty on this product "	"I do not know if there is a warranty on this product"	"BE_HAVE_MD_QUESTION"
"How do we get to the museum "	"I do not know how you get to the museum"	"WQUES"
"I have a green card , do I need a visa"	"I do not know if you need a visa"	"DO_QUESTION"
"Is GRAM accessible to people with special needs "	"I do not know if gram is accessible to people with special needs"	"BE_HAVE_MD_QUESTION"
"How soon will I receive the replacement product "	"I do not know how soon you will receive the replacement product"	"WQUES"
"What is a Labor Management Committee "	"I do not know what a Labor Management Committee is"	"WQUES"
"A new employee started work on 1 June ; how much annual leave can they take until the next leave year "	"I do not know how much annual leave can they take until the next leave year A new employee started work on 1 June ;"	"WQUES"
"Are you having a sale for July 4th "	"I do not know if I am having a sale for July 4th"	"BE_HAVE_MD_QUESTION"
"Can I pay for a full year "	"I do not know if you can pay for a full year"	"BE_HAVE_MD_QUESTION"
"How long does it take to update my payment information "	"I do not know how long it takes to update your payment information"	"WQUES"
"I would like to request a new card "	"I do not know how to request a new card"	"IMPERATIVE"
"How much is the cheapest postal delivery service for my package ? I do n't want to pay a great deal"	"I do not know how much the cheapest postal delivery service for your package is"	"WQUES"
"What Are the Camp 's Food Policies "	"I do not know what the Camp 's Food Policies Are"	"WQUES"
"Can a ticket booked with Blue Credits be changed or cancelled "	"I do not know if a ticket can booked with Blue Credits be changed or cancelled"	"BE_HAVE_MD_QUESTION"
"At what age can a child legally be left alone to care for themselves "	"I do not know at what age a child can legally be left alone to care for themselves"	"WQUES"
"How do I reserve 10 or more hotel rooms "	"I do not know how do you reserve 10 or more hotel rooms"	"WQUES_SIMPLE"
"What 's the currency "	"I do not know what the currency 's"	"WQUES"
"Is an employer required to electronically store the smart version of the Form I-9 "	"I do not know if an employer is required to electronically store the smart version of the Form I-9"	"BE_HAVE_MD_QUESTION"
"Is there a way to expedite shipping "	"I do not know if there is a way to expedite shipping"	"BE_HAVE_MD_QUESTION"
"Can you tell me what card I used to place this order "	"I do not know if I can tell you what card you used to place this order"	"BE_HAVE_MD_QUESTION"
"Do you charge sales tax "	"I do not know if I charge sales tax"	"DO_QUESTION"
"What kind of educational programming does The Carle Offer "	"I do not know what kind of educational programming does The Carle Offer"	"WQUES_SIMPLE"
"How do I reset my password for my login "	"I do not know how you reset your password for your login"	"WQUES"
"Why an Independent Studio and not a Franchised Dance Studio "	"I do not know why an Independent Studio and not a Franchised Dance Studio"	"WQUES_SIMPLE"
"Does the Uffizi have wheelchairs for disabled visitors "	"I do not know if the Uffizi has wheelchairs for disabled visitors"	"DO_QUESTION"
"Can I buy a flight ticket from a self-service check-in machine at the airport "	"I do not know if you can buy a flight ticket from a self-service check-in machine at the airport"	"BE_HAVE_MD_QUESTION"
"Where is the closest parking lot to the Museum "	"I do not know where the closest parking lot to the Museum is"	"WQUES"
"I have n't received my order ; can you track it please "	"I do not know if I can track it"	"BE_HAVE_MD_QUESTION"
"For your new line of products , what kind of features are offered "	"I do not know how to for my new line of"	"IMPERATIVE"
"I need an update on my order status"	"I do not know how to an update on your order status"	"IMPERATIVE"
"What if I register late "	"I do not know what you if register late"	"WQUES"
"It says my order is still processing , what does that mean "	"I do not know it says your order is still processing , what does that mean"	"WSUBJ"
"I think I was overcharged last month"	"I do not know how to handle 'I think I was overcharged last month'"	"CANONICAL_IDK"
"How do we get to Henry Ford Museum of American Innovation "	"I do not know how you get to Henry Ford Museum of American Innovation"	"WQUES"
"Are Pre booked tickets refundable "	"I do not know if pre are booked tickets refundable"	"BE_HAVE_MD_QUESTION"
"How can I become a volunteer at the Gilbert House "	"I do not know how you can become a volunteer at the Gilbert House"	"WQUES"
"Why do we have to pay for admission "	"I do not know why you have to pay for admission"	"WQUES"
"I ordered my pizza 2 hours ago and I have n't received my delivery , could you please check when I will get my delivery of pizza "	"I do not know when you will get your delivery of pizza"	"WQUES"
"Why that name "	"I do not know why that name"	"WQUES_SIMPLE"
"What are the top activities to do in this country "	"I do not know what the top activities to do in this country are"	"WQUES"
"Does recent action by the Georgia General Assembly regarding the asset threshold and retroactivity affect the program "	"I do not know if recent action by the Georgia General Assembly regarding the asset threshold and retroactivity affect the program"	"DO_QUESTION"
"Why is it called the Sixth Floor Museum at Dealey Plaza"	"I do not know why it is called the Sixth Floor Museum at Dealey Plaza"	"WQUES"
"Can I get a rain check since the item is out of stock "	"I do not know if you can get a rain check since the item is out of stock"	"BE_HAVE_MD_QUESTION"
"Does the table come in oak "	"I do not know if the table comes in oak"	"DO_QUESTION"
"Do you provide a discount for educators "	"I do not know if I provide a discount for educators"	"DO_QUESTION"
"Where do I find the breakdown of this months bill "	"I do not know where you find the breakdown of this months bill"	"WQUES"
"Which airlines do you use and can I take a train in/out of the country "	"I do not know which airlines I use and can you take a train in/out of the country"	"WQUES"
"My promo code did n't work "	"I do not know how to handle 'My promo code did n't work '"	"CANONICAL_IDK"
"Can you review the last purchases made on my account "	"I do not know if I can review the last purchases made on your account"	"BE_HAVE_MD_QUESTION"
"What is a Uniform Schengen Visa "	"I do not know what a Uniform Schengen Visa is"	"WQUES"
"Are you closed on Holidays "	"I do not know if me are closed on Holidays"	"BE_HAVE_MD_QUESTION"
"I am traveling to Detroit on Tuesday . Do you have any junior suites with king size refrigerators "	"I do not know if I have any junior suites with king size refrigerators"	"DO_QUESTION"
"How do I cancel an existing class reservation "	"I do not know how you cancel an existing class reservation"	"WQUES"
"What are the differences between the Intel Media Server Studio editions , and why should I upgrade to the Professional edition "	"I do not know why you should upgrade to the Professional edition"	"WQUES"
"I am planning a day-trip for my family . What other things are in the area that we might enjoy "	"I do not know what other things are in the area that you might enjoy"	"WQUES_SIMPLE"
"Who staffs the Camp-In "	"I do not know who staffs the Camp-In"	"WSUBJ"
"Will I see baby hippo Fiona on my visit "	"I do not know if you will see baby hippo Fiona on your visit"	"BE_HAVE_MD_QUESTION"
"Can I rent the museum facility for an event or film shoot "	"I do not know if you can rent the museum facility for an event or film shoot"	"BE_HAVE_MD_QUESTION"
"What happens when there is no optimal point during the Fresh Wake/Smart alarm time frame "	"I do not know what happens when there is no optimal point during the Fresh Wake/Smart alarm time frame"	"WSUBJ"
"How Can I Avoid the Crowds at Old Faithful "	"I do not know how you Can Avoid the Crowds at Old Faithful"	"WQUES"
"I do not work the regular 8:45 a.m. -- 5 p.m. work schedule . How will I know if and when I need to report to work if the University had an early dismissal or did not open "	"I do not know how to 5 p.m. work"	"IMPERATIVE"
"Can you bring up my payment history "	"I do not know if I can bring up your payment history"	"BE_HAVE_MD_QUESTION"
"Can you update my account information "	"I do not know if I can update your account information"	"BE_HAVE_MD_QUESTION"
"Will I be able to set up a payment plan "	"I do not know if you will be able to set up a payment plan"	"BE_HAVE_MD_QUESTION"
"Is there a social story or visual guide to the museum for my family to review "	"I do not know if there is a social story or visual guide to the museum for your family to review"	"BE_HAVE_MD_QUESTION"
"When is payday "	"I do not know when payday is"	"WQUES"
"What is the Museum of the Rockies best known for "	"I do not know what the Museum of the Rockies known for is best"	"WQUES"
"I forgot to bring my membership card ; can I still visit the zoo for Free"	"I do not know if you can still visit the zoo for Free"	"BE_HAVE_MD_QUESTION"
"Can you remove the card that I have on file "	"I do not know if I can remove the card that you have on file"	"BE_HAVE_MD_QUESTION"
"If an attraction that is not normally a zoo features a bird of prey show does the ZLA apply "	"I do not know how to handle 'If an attraction that is not normally a zoo features a bird of prey show does the ZLA apply '"	"CANONICAL_IDK"
"will you help me access your change of address page "	"I do not know if I will help you access my change of address page"	"BE_HAVE_MD_QUESTION"
"How do I access XFINITY WiFi "	"I do not know how do you access XFINITY WiFi"	"WQUES_SIMPLE"
"Do I qualify for a credit limit increase "	"I do not know if you qualify for a credit limit increase"	"DO_QUESTION"
"What are the minimum technical requirements for the Minecraft : Education Edition software "	"I do not know what the minimum technical requirements for the Minecraft : Education Edition software are"	"WQUES"
"What do I do if I need to access Workday to view or change my information but do n't have a computer "	"I do not know what you do if you need to access Workday to view or change your information but do n't have a computer"	"WQUES"
"I 'd like to find out what other offers you have "	"I do not know what other offers I have"	"WQUES"
"Is there a car park at the Fashion Museum "	"I do not know if there is a car park at the Fashion Museum"	"BE_HAVE_MD_QUESTION"
"How can I get my reward "	"I do not know how you can get your reward"	"WQUES"
"Can I get points for referrals "	"I do not know if you can get points for referrals"	"BE_HAVE_MD_QUESTION"
"My insurance agent said my insurance policy would lapse if it 's not paid , but it 's on auto-pay directly from my bank . What went wrong "	"I do not know what went wrong"	"WSUBJ"
"How can I track my package "	"I do not know how you can track your package"	"WQUES"
"I want to buy this particular set as a gift for my friends up coming wedding . Do you guys do gift receipts and wrapping "	"I do not know how to buy this particular set as a gift for your friends up coming wedding ."	"IMPERATIVE"
"Are you handicap accessible "	"I do not know if I am handicap accessible"	"BE_HAVE_MD_QUESTION"
"My order is wrong "	"I do not know how to handle 'My order is wrong '"	"CANONICAL_IDK"
"Would it be possible to get my purchase gift wrapped "	"I do not know if it would be possible to get your purchase gift wrapped"	"BE_HAVE_MD_QUESTION"
"I need to change my credit card information . Can you help me "	"I do not know how to change your credit card information ."	"IMPERATIVE"
"How long should we plan on visiting "	"I do not know how long you should plan on visiting"	"WQUES"
"Can you tell me what the difference is between the Model X and the Model S "	"I do not know if I can tell you what the difference is between the Model X and the Model S"	"BE_HAVE_MD_QUESTION"
"Just how much ground coffee do I need for x amount of coffee "	"I do not know how to handle 'Just how much ground coffee do I need for x amount of coffee '"	"CANONICAL_IDK"
"I want this product but I only see a bulk option , is it possible for me to get this from you in a single "	"I do not know if it is possible for you to get this from me in a single"	"BE_HAVE_MD_QUESTION"
"What is the fee for expedited shipping "	"I do not know what the fee for expedited shipping is"	"WQUES"
"Can you give me the number to my local library "	"I do not know if I can give you the number to your local library"	"BE_HAVE_MD_QUESTION"
"What credit options are available for people with bad credit "	"I do not know what credit options are available for people with bad credit"	"WQUES_SIMPLE"
"Does the Museum have any traveling exhibits "	"I do not know if the Museum has any traveling exhibits"	"DO_QUESTION"
"What if I want to cancel my subscription "	"I do not know what you if want to cancel your subscription"	"WQUES"
"When is Jazz incorporated to a child 's curriculum "	"I do not know when Jazz incorporated to a child 's curriculum is"	"WQUES"
"Do you offer reserved seating "	"I do not know if I offer reserved seating"	"DO_QUESTION"
"Are there any free cookies with purchase "	"I do not know if there are any free cookies with purchase"	"BE_HAVE_MD_QUESTION"
"I accidentally made two payments , can one be reversed "	"I do not know if one can be reversed"	"BE_HAVE_MD_QUESTION"
"I am unable to pay my delinquent taxes . Will the IRS accept an offer in compromise "	"I do not know if the IRS will accept an offer in compromise"	"BE_HAVE_MD_QUESTION"
"Do you have a rewards or frequent shoppers program "	"I do not know if I have a rewards or frequent shoppers program"	"DO_QUESTION"
"What if I 'm still not sure the email is from USAJOBS "	"I do not know what if you are still not sure the email is from USAJOBS"	"WQUES_SIMPLE"
"What size companies do you typical work with and is a company ever too small or too large for you to support "	"I do not know what size companies do I typical work with and is a company ever too small or too large for I to support"	"WQUES_SIMPLE"
"Can I touch the art "	"I do not know if you can touch the art"	"BE_HAVE_MD_QUESTION"
"Do I need a partner "	"I do not know if you need a partner"	"DO_QUESTION"
"Does the Lawn Pass include a lawn chair rental"	"I do not know if the Lawn Pass includes a lawn chair rental"	"DO_QUESTION"
"Who do I call to stop telemarketing calls "	"I do not know who you call to stop telemarketing calls"	"WQUES"
"What should be kept in an Employee File and who should have access to it "	"I do not know what should be kept in an Employee File and who should have access to it"	"WSUBJ"
"Is her makeup on order"	"I do not know if her makeup is on order"	"BE_HAVE_MD_QUESTION"
"Why ca n't I take photos in the Feature Gallery "	"I do not know why you ca n't take photos in the Feature Gallery"	"WQUES"
"How can my family and friends call me "	"I do not know how your family and friends can friends call you"	"WQUES"
"Do you guys ship to Indonesia "	"I do not know if I guys ship to Indonesia"	"DO_QUESTION"
"How much is the economy shipping method "	"I do not know how much the economy shipping method is"	"WQUES"
"Do you have any ways for me to save money "	"I do not know if I have any ways for you to save money"	"DO_QUESTION"
"Can I use my debit card for the transaction "	"I do not know if you can use your debit card for the transaction"	"BE_HAVE_MD_QUESTION"
"When will your holiday sale begin "	"I do not know when my holiday sale will begin"	"WQUES"
"Can individuals make reservations to see the Science Show "	"I do not know if individuals can make reservations to see the Science Show"	"BE_HAVE_MD_QUESTION"
"Do I have to call to schedule a tour "	"I do not know if you have to call to schedule a tour"	"DO_QUESTION"
"Are Toyota Rent a Car rates competitive with other rental agencies "	"I do not know if Toyota Rent a Car rates are competitive with other rental agencies"	"BE_HAVE_MD_QUESTION"
"Can you give me the pick up schedule for the mail on the weekends "	"I do not know if I can give you the pick up schedule for the mail on the weekends"	"BE_HAVE_MD_QUESTION"
"Does the Museum appraise objects and artifacts "	"I do not know if the Museum appraises objects and artifacts"	"DO_QUESTION"
"What 's the least expensive way to ship my order "	"I do not know what the expensive way to ship your order 's least"	"WQUES"
"I am not satisfied about the product that I bought . How can I go about returning it "	"I do not know how you can go about returning it"	"WQUES"
"Who operates the Virginia Zoo "	"I do not know who operates the Virginia Zoo"	"WSUBJ"
"How do I purchase classes online "	"I do not know how you purchase classes online"	"WQUES"
"Can you pre-order this item "	"I do not know if I can pre-order this item"	"BE_HAVE_MD_QUESTION"
"How is privacy guaranteed "	"I do not know how privacy is guaranteed"	"WQUES"
"Will self service work on my mobile or tablet "	"I do not know if self will service work on your mobile or tablet"	"BE_HAVE_MD_QUESTION"
"Can I pay over the phone "	"I do not know if you can pay over the phone"	"BE_HAVE_MD_QUESTION"
"How are Barnard and Columbia related "	"I do not know how Barnard and Columbia related are Columbia"	"WQUES"
"Can you fax me my invoice "	"I do not know if I can fax you your invoice"	"BE_HAVE_MD_QUESTION"
"The customer rep I spoke with promised I could have the premium package at the regular price but I 've been billed too much "	"I do not know how to handle 'The customer rep I spoke with promised I could have the premium package at the regular price but I 've been billed too much '"	"CANONICAL_IDK"
"In your advertisement you state that the warranty is for two years . I received the product and it state one year . Which is correct "	"I do not know which is correct"	"WSUBJ"
"When does the Government of Canada issue a Travel Advisory "	"I do not know when does the Government of Canada issue a Travel Advisory"	"WQUES_SIMPLE"
"How soon will a service person be available "	"I do not know how soon will a service person be available"	"WQUES_SIMPLE"
"I get a not listening on ... error from upsd "	"I do not know how to error from upsd"	"IMPERATIVE"
"What is this charge that was placed on my account yesterday "	"I do not know what this charge that was placed on your account yesterday is"	"WQUES"
"How long do internships last "	"I do not know how long do internships last"	"WQUES_SIMPLE"
"I 'd like to have my order shipped to someone else , what do I do "	"I do not know if your order have shipped to someone else , what you do"	"BE_HAVE_MD_QUESTION"
"What information must be included in the health care exchange notice that an employer is required to provide to employees under the Affordable Care Act -LRB- ACA -RRB- "	"I do not know what information must be included in the health care exchange notice that an employer is required to provide to employees under the Affordable Care Act -LRB- ACA -RRB-"	"WQUES_SIMPLE"
"Is the library at the Stedelijk accessible "	"I do not know if the library is at the Stedelijk accessible"	"BE_HAVE_MD_QUESTION"
"Can you please help me change my password "	"I do not know if I can help you change your password"	"BE_HAVE_MD_QUESTION"
"Can you tell me the hours that customer service is open "	"I do not know if I can tell you the hours that customer service is open"	"BE_HAVE_MD_QUESTION"
"I am a NYC school teacher or camp counselor . What is the admissions fee for my students/campers"	"I do not know what the admissions fee for your students/campers is"	"WQUES"
"How do I know if my order went through successfully"	"I do not know how you know if your order went through successfully"	"WQUES"
"How long until the connection is back up and running "	"I do not know how long until the connection is back up and running"	"WQUES_SIMPLE"
"Where do I find out about rental facilities "	"I do not know where you find out about rental facilities"	"WQUES"
"Do you have any salmon "	"I do not know if I have any salmon"	"DO_QUESTION"
"Who do I contact for help with the site "	"I do not know who you contact for help with the site"	"WQUES"
"Can I bring my pet with me on my visit"	"I do not know if you can bring your pet with you on your visit"	"BE_HAVE_MD_QUESTION"
"What are some key aspects of workplace violence prevention training "	"I do not know what some key aspects of workplace violence prevention training are"	"WQUES"
"Can I make repairs to my lease vehicle so I do n't incur wear and use charges "	"I do not know if you can make repairs to your lease vehicle so you n't incur wear and use charges"	"BE_HAVE_MD_QUESTION"
"Do you charge shipping by the pound or size of the box "	"I do not know if I charge shipping by the pound or size of the box"	"DO_QUESTION"
"I need the order I just made shipped elsewhere "	"I do not know how to handle 'I need the order I just made shipped elsewhere '"	"CANONICAL_IDK"
"Are baby strollers permitted in the Museum "	"I do not know if baby strollers are permitted in the Museum"	"BE_HAVE_MD_QUESTION"
"Do you know when the newest model is coming out after this item "	"I do not know if I know when the newest model is coming out after this item"	"DO_QUESTION"
"Can I lower the price per piece if I order by the hundreds "	"I do not know if you can lower the price per piece if you order by the hundreds"	"BE_HAVE_MD_QUESTION"
"What is the latest I could call in to customer service and still have enough time "	"I do not know what the latest you could call in to customer service and have enough time is still"	"WQUES"
"How long will it take to process my application "	"I do not know how long it will take to process your application"	"WQUES"
"What is Co-Employment "	"I do not know what Co-Employment is"	"WQUES"
"How long will it take to get my order "	"I do not know how long it will take to get your order"	"WQUES"
"Where can I get information on the level of calories , fat , protein , vitamins and minerals in various foods "	"I do not know where you can get information on the level of calories , fat , protein , vitamins and minerals in various foods"	"WQUES"
"Do families with multiple students get a discount "	"I do not know if families with multiple students get a discount"	"DO_QUESTION"
"I forgot to pack something . Where can I purchase essential items "	"I do not know where you can purchase essential items"	"WQUES"
"Where can I find a realtor "	"I do not know where you can find a realtor"	"WQUES"
"What is succession planning "	"I do not know what succession planning is"	"WQUES"
"I 'm scheduled to receive respite care for Mr. Wilson on Wednesday the 11th , but need to reschedule to Thursday the 12th "	"I do not know how to you are scheduled to receive respite care for Mr. Wilson on Wednesday the"	"IMPERATIVE"
"What clinical trials need to be registered in clinicaltrials.gov "	"I do not know what clinical trials to be registered in clinicaltrials.gov What clinical trials need"	"WQUES"
"How many membership cards will I receive "	"I do not know how many membership cards you will receive"	"WQUES"
"I will be arriving at JFK airport at 7 AM and need my options for transportation to my destination "	"I do not know how to handle 'I will be arriving at JFK airport at 7 AM and need my options for transportation to my destination '"	"CANONICAL_IDK"
"Is there any way you can help me reset my password for my debit card ? I lost the paper it came with "	"I do not know if there is any way I can help you reset your password for your debit card"	"BE_HAVE_MD_QUESTION"
"According to your estimated delivery date , my order is supposed to arrive tomorrow , but the tracking shows no information and says the item might be lost , can you help me "	"I do not know how to according to my estimated delivery"	"IMPERATIVE"
"In what languages can I book an Introductory program for groups "	"I do not know in what languages you can book an Introductory program for groups"	"WQUES"
"Does the Alf Museum have a gift shop "	"I do not know if the Alf Museum has a gift shop"	"DO_QUESTION"
"I need to know the average annual rainfall for San Francisco for each of the last ten years "	"I do not know what the average annual rainfall for San Francisco for each of the last ten years is"	"WQUES"
"When is my account set to expire "	"I do not know when your account is set to expire"	"WQUES"
"I do n't like dealing with automated systems , what is the direct phone number for a person at your corporate headquarters "	"I do not know you n't like dealing with automated systems , what is the direct phone number for a person at my corporate headquarters"	"WSUBJ"
"How do I go about sponsoring the museum and what do I receive in return"	"I do not know how you go about sponsoring the museum and what do you receive in return"	"WQUES"
"What forms of payment does Utah 's Hogle Zoo accept "	"I do not know what forms of payment Utah 's Hogle Zoo accepts"	"WQUES_SIMPLE"
"How do I arrange for a group visit or tour of the AD&A Museum "	"I do not know how you arrange for a group visit or tour of the AD&A Museum"	"WQUES"
"Can I have two contact numbers on my account "	"I do not know if you can have two contact numbers on your account"	"BE_HAVE_MD_QUESTION"
"Are you open all year round "	"I do not know if I am open all year round"	"BE_HAVE_MD_QUESTION"
"Are there any partner hotels "	"I do not know if there are any partner hotels"	"BE_HAVE_MD_QUESTION"
"Can you please check my August bill ? There are some charges that I do not understand "	"I do not know if I can check your August bill"	"BE_HAVE_MD_QUESTION"
"I gave the wrong phone number in my order , how do I fix that "	"I do not know how you fix that"	"WQUES"
"Will it fit through my doorways "	"I do not know if it will fit through your doorways"	"BE_HAVE_MD_QUESTION"
"What nutrients does peanut butter provide "	"I do not know what nutrients peanut butter provides"	"WQUES_SIMPLE"
"How do I get to the Museum "	"I do not know how you get to the Museum"	"WQUES"
"Is distance learning available at the graduate level "	"I do not know if distance learning is available at the graduate level"	"BE_HAVE_MD_QUESTION"
"I recently placed an order and need to change the delivery address , can you help me "	"I do not know if I can help you"	"BE_HAVE_MD_QUESTION"
"How is leasing different from a conventional purchase "	"I do not know how is leasing different from a conventional purchase"	"WQUES_SIMPLE"
"How long does it take to visit the zoo"	"I do not know how long it takes to visit the zoo"	"WQUES"
"Do you offer rain checks for items that have sold out on the site "	"I do not know if I offer rain checks for items that have sold out on the site"	"DO_QUESTION"
"How do you get to the museum and where can we park "	"I do not know how I get to the museum and where can you park"	"WQUES"
"I was consuming one of your products and found a piece of metal in it . Can you help me with resolving this issue "	"I do not know if I can help you with resolving this issue"	"BE_HAVE_MD_QUESTION"
"I like the UN Job List , what can I do to help "	"I do not know the UN Job List , what can you do to help you can do to help"	"WQUES"
"If I leave other electronic around this product will it still behave the same "	"I do not know if it will still behave the same"	"BE_HAVE_MD_QUESTION"
"I want to enroll in my cobra coverage , can i enroll with over the phone "	"I do not know how to enroll in your cobra"	"IMPERATIVE"
"Do you have a brick-and-mortar shop "	"I do not know if I have a brick-and-mortar shop"	"DO_QUESTION"
"Will DACA recipients still be able to travel outside of the United States while their DACA is valid "	"I do not know if daca recipients will still be able to travel outside of the United States while their DACA is valid"	"BE_HAVE_MD_QUESTION"
"What is the Berlin Document Center "	"I do not know what the Berlin Document Center is"	"WQUES"
"Can I get a discount because you do n't have what I wanted "	"I do not know if you can get a discount because I n't have what you wanted"	"BE_HAVE_MD_QUESTION"
"Can I get a copy of my account summary "	"I do not know if you can get a copy of your account summary"	"BE_HAVE_MD_QUESTION"
"Please show me some other options in this same or similar size and color"	"I do not know how to show you some other options in this same or similar size and color"	"IMPERATIVE"
"What is the Gallery Photography Policy"	"I do not know what the Gallery Photography Policy is"	"WQUES"
"How did the Spruce Goose get here "	"I do not know how the Spruce Goose get here"	"WQUES"
"I 've read reports that your shareowners have submitted proposals asking you to eliminate BPA from your cans and you have refused to do so . Is that true "	"I do not know if that is true"	"BE_HAVE_MD_QUESTION"
"Do we have to bring a stroller or can we rent one "	"I do not know if you have to bring a stroller or can you rent one"	"DO_QUESTION"
"I need to book a room for two adults for five nights-can you tell me what your best rate is "	"I do not know book a room for two adults for five nights-can I tell you what my best rate is a room for two adults for five nights-can I tell you"	"WQUES"
"Can I change my coverage during the year "	"I do not know if you can change your coverage during the year"	"BE_HAVE_MD_QUESTION"
"Can private clubs have museum or historic site signs "	"I do not know if private clubs can have museum or historic site signs"	"BE_HAVE_MD_QUESTION"
"I 'd like to change my address for my online account but it wo n't let me . Can you help me resolve this "	"I do not know if I can help you resolve this"	"BE_HAVE_MD_QUESTION"
"How late can I order room service "	"I do not know how late you can order room service"	"WQUES"
"What happens if I have a lapse in coverage in 2015 "	"I do not know what happens if you have a lapse in coverage in 2015"	"WSUBJ"
"I am a beginner . Do I need to know anything before I come to my first class "	"I do not know if you need to know anything before you come to your first class"	"DO_QUESTION"
"My order arrived and one item is missing "	"I do not know how to handle 'My order arrived and one item is missing '"	"CANONICAL_IDK"
"I received new license plates in the mail or my renewal notice says I am due for reissue . What is this for "	"I do not know what this is"	"WQUES"
"Does my work have to be published to be protected "	"I do not know if your work have to be published to be protected"	"DO_QUESTION"
"How can I decrease the cost of shipping "	"I do not know how you can decrease the cost of shipping"	"WQUES"
"Hi , I was hoping you could help me preorder Children of Virtue and Vengeance by Tomi Adeyemi "	"I do not know how to handle 'Hi , I was hoping you could help me preorder Children of Virtue and Vengeance by Tomi Adeyemi '"	"CANONICAL_IDK"
"How do I contact the Illinois Secretary of State "	"I do not know how you contact the Illinois Secretary of State"	"WQUES"
"Will you match the sale price offered by another store "	"I do not know if I will match the sale price offered by another store"	"BE_HAVE_MD_QUESTION"
"In lieu of gifts , can we collect donations to Adopt-An-Animal through the Valley Zoo Development Society or to buy an elephant or seal painting "	"I do not know how to in lieu of"	"IMPERATIVE"
"Will the benefits of my Senior Pass change "	"I do not know if the will benefits of your Senior Pass change"	"BE_HAVE_MD_QUESTION"
"Can a hospital receive both Medicare and Medicaid EHR incentive payments "	"I do not know if a hospital can receive both Medicare and Medicaid EHR incentive payments"	"BE_HAVE_MD_QUESTION"
"Are there benches in the galleries or other places to rest during my visit "	"I do not know if there are benches in the galleries or other places to rest during your visit"	"BE_HAVE_MD_QUESTION"
"What age range is the Miffy Museum suitable for "	"I do not know what age range is the Miffy Museum suitable for"	"WQUES_SIMPLE"
"I want to cancel my subscription "	"I do not know how to cancel your subscription"	"IMPERATIVE"
"Is there parking on-site "	"I do not know if there is parking on-site"	"BE_HAVE_MD_QUESTION"
"Are there Friends of the Prado in Spain "	"I do not know if there are Friends of the Prado in Spain"	"BE_HAVE_MD_QUESTION"
"Can I finance a boat , motorcycle or recreational vehicle with Chase "	"I do not know if you can finance a boat , motorcycle or recreational vehicle with Chase"	"BE_HAVE_MD_QUESTION"
"Is there kosher food at the museum "	"I do not know if there is kosher food at the museum"	"BE_HAVE_MD_QUESTION"
"I would like to know how to register a marriage certificate if my driver 's license still has n't arrived in the mail yet "	"I do not know how to register a marriage certificate if your driver 's license still has n't arrived in the mail yet"	"WQUES_SIMPLE"
"Do you have a customer loyalty program"	"I do not know if I have a customer loyalty program"	"DO_QUESTION"
"When will the new model be released "	"I do not know when the new model will be released"	"WQUES"
"How far in advance can I book a ticket"	"I do not know how far in advance you can book a ticket"	"WQUES"
"Can clergy members visit patients "	"I do not know if clergy members can visit patients"	"BE_HAVE_MD_QUESTION"
"Can I work with faculty on research projects "	"I do not know if you can work with faculty on research projects"	"BE_HAVE_MD_QUESTION"
"Does the train ride take you through the entire zoo "	"I do not know if the train ride takes me through the entire zoo"	"DO_QUESTION"
"I read there is a recall on your carpet . I had it installed last month , should I be worried "	"I do not know if you should be worried"	"BE_HAVE_MD_QUESTION"
"Where do we meet if we already have tickets "	"I do not know where you meet if you already have tickets"	"WQUES"
"Can I cancel my award ticket "	"I do not know if you can cancel your award ticket"	"BE_HAVE_MD_QUESTION"
"Why is DHS phasing out the DACA program "	"I do not know why DHS is phasing out the DACA program"	"WQUES"
"Do you rent strollers & wheelchairs "	"I do not know if I rent strollers & wheelchairs"	"DO_QUESTION"
"What 's the email address for submitting safety complaints about your toys "	"I do not know what the email address for submitting safety complaints about my toys 's"	"WQUES"
"I need to extend my stay by one day"	"I do not know how to extend your stay by one day"	"IMPERATIVE"
"What are the hours of the Museum and the Glass Studio "	"I do not know what the hours of the Museum and the Glass Studio are"	"WQUES"
"Will there be ATMs available at the event "	"I do not know if there will be ATMs available at the event"	"BE_HAVE_MD_QUESTION"
"How many days will jury service last "	"I do not know how many days will jury service last"	"WQUES_SIMPLE"
"Why did I get billed more than what the item was listed at "	"I do not know why you get billed more than what the item was listed at"	"WQUES"
"Where is your produce sourced from "	"I do not know where is my produce sourced from"	"WQUES_SIMPLE"
"Looking for a specific piece in one of the museum 's collections "	"I do not know how to looking for a specific piece in one of the museum 's collections"	"IMPERATIVE"
"There are people who say that visiting a country such as North Korea is wrong and that all we are doing is supporting the government - is this true "	"I do not know if this is true"	"BE_HAVE_MD_QUESTION"
"How do I close down the account for a deceased relative "	"I do not know how you close down the account for a deceased relative"	"WQUES_SIMPLE"
"May I loan my membership card to another person "	"I do not know if you may loan your membership card to another person"	"BE_HAVE_MD_QUESTION"
"What is your refund policy "	"I do not know what my refund policy is"	"WQUES"
"Do you have any deals going on right now "	"I do not know if I have any deals going on right now"	"DO_QUESTION"
"How do you feel when your bucket is full "	"I do not know how I feel when my bucket is full"	"WQUES"
"I canceled my subscription 2 months ago but I was just billed again today , can you help "	"I do not know if I can help"	"BE_HAVE_MD_QUESTION"
"What can I do if I do not have a current address "	"I do not know what you can do if you not have a current address"	"WQUES"
"If I want something to arrive by Christmas , how early do I need to have it shipped "	"I do not know something to arrive by Christmas , how early you need to have it shipped you If want something"	"WQUES"
"When do you guys think you will have this item in store again "	"I do not know when I guys think I will have this item in store again"	"WQUES"
"Who operates the Web site "	"I do not know who operates the Web site"	"WSUBJ"
"I need to file a complaint about the associate I spoke with "	"I do not know how to handle 'I need to file a complaint about the associate I spoke with '"	"CANONICAL_IDK"
"I 'd like to change some personal information on my account but the system wo n't let me . Can you help me with this "	"I do not know if I can help you with this"	"BE_HAVE_MD_QUESTION"
"Can you tell me the weight limit per bag "	"I do not know if I can tell you the weight limit per bag"	"BE_HAVE_MD_QUESTION"
"Where do you get your cars "	"I do not know where I get my cars"	"WQUES"
"Does Silver Dollar City have fireworks on the 4th of July "	"I do not know if silver Dollar City have fireworks on the 4th of July"	"DO_QUESTION"
"Do you offer any Zumba classes in the evenings "	"I do not know if I offer any Zumba classes in the evenings"	"DO_QUESTION"
"Who can I talk to to check on my order "	"I do not know who you can talk to to check on your order"	"WQUES"
"Why are there two entries , non-series title and series title , for many headings listed in the search results of a Title Authority Heading search "	"I do not know why two entries are there , non-series title and series title , for many headings listed in the search results of a Title Authority Heading search"	"WQUES"
"Is L.A. Zoo Lights appropriate for kids "	"I do not know if L.A. Zoo Lights is appropriate for kids"	"BE_HAVE_MD_QUESTION"
"Does your return policy cover if I want to return an unopened product because I found it at a lower price somewhere else "	"I do not know if my return policy cover if you want to return an unopened product because you found it at a lower price somewhere else"	"DO_QUESTION"
"How is Amazon S3 data organized "	"I do not know how Amazon S3 data is organized"	"WQUES"
"Can you tell me if this is a seasonal item "	"I do not know if I can tell you if this is a seasonal item"	"BE_HAVE_MD_QUESTION"
"Does Chester Zoo do anything to help animals in the wild "	"I do not know if Chester Zoo do anything to help animals in the wild"	"DO_QUESTION"
"Is there a way for me to compare your guaranteed life income annuities to MetLife 's ? I was approached by an agent a week ago , but I like your service so I wanted to see what you thought first "	"I do not know if there is a way for you to compare my guaranteed life income annuities to MetLife 's"	"BE_HAVE_MD_QUESTION"
"Are there any other choices for me "	"I do not know if there are any other choices for you"	"BE_HAVE_MD_QUESTION"
"Are elected officials required to take training on the Freedom of Access Act "	"I do not know how to handle 'Are elected officials required to take training on the Freedom of Access Act '"	"CANONICAL_IDK"
"How do I return something that I received as a gift"	"I do not know how you return something that you received as a gift"	"WQUES"
"When is the best time to visit to avoid large crowds "	"I do not know when the best time to visit to avoid large crowds is"	"WQUES"
"How do I add another user to my account "	"I do not know how you add another user to your account"	"WQUES"
"Is the IRS Form 941-M still in use "	"I do not know if the IRS Form 941-M is still in use"	"BE_HAVE_MD_QUESTION"
"My router is n't connecting to the Internet , and I 've already tried resetting it a few times . Are you all having connectivity issues "	"I do not know if I am all having connectivity issues"	"BE_HAVE_MD_QUESTION"
"Is your meat delivered fresh or frozen "	"I do not know if my meat is delivered fresh or frozen"	"BE_HAVE_MD_QUESTION"
"Which countries are considered State Sponsors of Terrorism "	"I do not know which countries are considered State Sponsors of Terrorism"	"WQUES_SIMPLE"
"I 'm not sure my order went through , can you check for me "	"I do not know if I can check for you"	"BE_HAVE_MD_QUESTION"
"Would you mind mailing your catalog to me "	"I do not know if I would mind mailing my catalog to you"	"BE_HAVE_MD_QUESTION"
"How much does Paragon Payroll & HR services cost "	"I do not know how much does Paragon Payroll & HR services cost"	"WQUES_SIMPLE"
"What 's your return policy on opened goods "	"I do not know what my return policy on opened goods 's"	"WQUES"
"Does Cezanne 's HR software work on Apple Macs "	"I do not know if Cezanne 's HR software work on Apple Macs"	"DO_QUESTION"
"Can my overdraft fee be waived as a one time courtesy "	"I do not know if your overdraft fee can be waived as a one time courtesy"	"BE_HAVE_MD_QUESTION"
"The codpiece I ordered for my dog does n't fit , and he need his medieval costume in 2 days , can you rush the bigger one to me "	"I do not know if I can rush the bigger one to you"	"BE_HAVE_MD_QUESTION"
"What is the name of the river flowing through Corning and where does it flow "	"I do not know what the name of the river flowing through Corning and does it flow is where"	"WQUES"
"Can I become a member of the Zoo "	"I do not know if you can become a member of the Zoo"	"BE_HAVE_MD_QUESTION"
"My program requires that I pass a state professional licensing exam and/or obtain a professional board certification before I can work in the state . How will the closure of ITT impact my ability to sit for my exam or obtain professional certification "	"I do not know how will the closure of ITT impact your ability to sit for your exam or obtain professional certification"	"WQUES_SIMPLE"
"May I loan my membership card to a family member or friend "	"I do not know if you may loan your membership card to a family member or friend"	"BE_HAVE_MD_QUESTION"
"How do I know if my device is compatible with the My Verizon app "	"I do not know how you know if your device is compatible with the your Verizon app"	"WQUES"
"I 'm overseas and I need to transfer funds , is there an international number to call "	"I do not know if there is an international number to call"	"BE_HAVE_MD_QUESTION"
"I have forgotten the time of my reservation , what should I do "	"I do not know the time of your reservation , what should you do you have forgotten"	"WQUES"
"How do employees make the switch this year "	"I do not know how employees make the switch this year"	"WQUES"
"How does an applicant obtain a copy of the background screening report "	"I do not know how an applicant obtains a copy of the background screening report"	"WQUES"
"I have a problem with an online ticket order , what should I do "	"I do not know what you should do"	"WQUES"
"Can I visit the museum without my Membership Card"	"I do not know if you can visit the museum without your Membership Card"	"BE_HAVE_MD_QUESTION"
"What is pu-erh "	"I do not know what pu-erh is"	"WQUES"
"What is your website address "	"I do not know what my website address is"	"WQUES"
"I would like to apply for an in-store position at one of your retail locations . Does your store allow people to go into the location and fill out an application or do I have to do it on line "	"I do not know how to apply for an in-store position at one of my retail locations ."	"IMPERATIVE"
"As it is within the 30 day agreement , I would like to cancel my window installation scheduled for September 30th "	"I do not know how to cancel your window installation scheduled for September 30th"	"IMPERATIVE"
"Can you provide attendance numbers "	"I do not know if I can provide attendance numbers"	"BE_HAVE_MD_QUESTION"
"Why ca n't I select ground shipping for my order "	"I do not know why you ca n't select ground shipping for your order"	"WQUES"
"Everything looks fine on the screen but when I print a picture , the entire image is flipped upside down and backwards . What 's the problem "	"I do not know when you print a picture"	"WQUES"
"Can I have a different vehicle than this one "	"I do not know if you can have a different vehicle than this one"	"BE_HAVE_MD_QUESTION"
"What is the duration for Conversations "	"I do not know what the duration for Conversations is"	"WQUES"
"How much is it for a school tour"	"I do not know how much it is for a school tour"	"WQUES"
"What is the counselor to camper ratio "	"I do not know what the counselor to camper ratio is"	"WQUES"
"When was Newmarket officially incorporated as a village "	"I do not know when Newmarket was officially incorporated as a village"	"WQUES"
"I like talking to you . Do you have a direct extension I can call you at next time "	"I do not know how to talking to me ."	"IMPERATIVE"
"Could you direct me through the start-up process "	"I do not know if I could direct you through the start-up process"	"BE_HAVE_MD_QUESTION"
"A service person was supposed to be at my house between 1:00 and 3:00 and it 's now 4 o'clock and nobody 's here , so can you help me "	"I do not know how to handle 'A service person was supposed to be at my house between 1:00 and 3:00 and it 's now 4 o'clock and nobody 's here , so can you help me '"	"CANONICAL_IDK"
"Where is the nearest available parking "	"I do not know where the nearest available parking is"	"WQUES"
"What 's new about the Product Returns Policy "	"I do not know what 's new about the Product Returns Policy"	"WSUBJ"
"How do I book a session -LRB- taught or self-guided -RRB-"	"I do not know how you book a session -LRB- taught or self-guided -RRB-"	"WQUES"
"Can you give me my account number to Spirit Airlines "	"I do not know if I can give you your account number to Spirit Airlines"	"BE_HAVE_MD_QUESTION"
"Are there alerts or notifications available for new publications "	"I do not know if there alerts or notifications are available for new publications"	"BE_HAVE_MD_QUESTION"
"Is there a drop-off location for people who want to donate books to the library "	"I do not know if there is a drop-off location for people who want to donate books to the library"	"BE_HAVE_MD_QUESTION"
"What does it mean to ' give notice ' to the other party "	"I do not know what it means to ' give notice ' to the other party"	"WQUES"
"I extend credit to people who buy cars from me through retail installment contracts . I keep the contracts and do not assign them to others . What are my obligations "	"I do not know to people who buy cars from you through retail installment contracts you extend credit ."	"WQUES"
"If I buy a Guided Tour for the Vatican Museums , is it possible to see the Vatican Gardens with the same ticket "	"I do not know if it is possible to see the Vatican Gardens with the same ticket"	"BE_HAVE_MD_QUESTION"
"I was hoping to reschedule my appointment to a later date . Can we reschedule to the 7th of September "	"I do not know if you can reschedule to the 7th of September"	"BE_HAVE_MD_QUESTION"
"Do you ever cancel tours due to the weather "	"I do not know if I ever cancel tours due to the weather"	"DO_QUESTION"
"My bill says I am overdue , but the payment came out of my account "	"I do not know how to handle 'My bill says I am overdue , but the payment came out of my account '"	"CANONICAL_IDK"
"Do I need to replace lost stickers "	"I do not know if you need to replace lost stickers"	"DO_QUESTION"
"My account name has changed . Do I need to request a new MileagePlus card "	"I do not know if you need to request a new MileagePlus card"	"DO_QUESTION"
"If I sign up for the 14-month subscription , what kind of discount do I get "	"I do not know what kind of discount you get"	"WQUES"
"Are the paintings and sculpture copies or originals "	"I do not know if the are paintings and sculpture copies or originals"	"BE_HAVE_MD_QUESTION"
"Can you alter my subscription to include more channels "	"I do not know if I can alter your subscription to include more channels"	"BE_HAVE_MD_QUESTION"
"Can I switch this car out tomorrow if I do n't like it "	"I do not know if you can switch this car out tomorrow if you n't like it"	"BE_HAVE_MD_QUESTION"
"Is there someone I can speak with at the Museum "	"I do not know if there is someone you can speak with at the Museum"	"BE_HAVE_MD_QUESTION"
"I would like to buy a gift Membership for someone . How can I do this "	"I do not know how to buy a gift Membership for someone ."	"IMPERATIVE"
"What if I do n't have my OHIO ID and password "	"I do not know what you if n't have your OHIO ID and password"	"WQUES"
"I 'd like to speak with your supervisor please . I have an item I 'd like to return and I ca n't seem to get it done "	"I do not know how to speak with my supervisor ."	"IMPERATIVE"
"Change my reservation to a single room"	"I do not know how to Change your reservation to a single room"	"IMPERATIVE"
"What 's the best way to store See 's chocolates after I receive my order "	"I do not know what the best way to store See 's chocolates after you receive your order 's"	"WQUES"
"I found the same item for a cheaper price at Best Buy , do you price match if I provide the store sales advertisement "	"I do not know if I price match if you provide the store sales advertisement"	"DO_QUESTION"
"How much does it cost for a suite over the weekend of the 25th ? I 'd like to make the reservation for both days "	"I do not know how much it costs for a suite over the weekend of the 25th"	"WQUES"
"How do I exchange my shirt for a different size "	"I do not know how you exchange your shirt for a different size"	"WQUES"
"If my order has n't shipped yet can I add another item to it "	"I do not know if you can add another item to it"	"BE_HAVE_MD_QUESTION"
"What are the hours of Wisteria , the Museum 's restaurant "	"I do not know what the hours of Wisteria , the Museum 's restaurant are"	"WQUES"
"What is the cheapest gym membership you offer "	"I do not know what the cheapest gym membership I offer is"	"WQUES"
"Does anyone go in with the tigers "	"I do not know if anyone goes in with the tigers"	"DO_QUESTION"
"Are they required to be potty trained "	"I do not know if they are required to be potty trained"	"BE_HAVE_MD_QUESTION"
"Can authority records be searched by LCCN "	"I do not know if authority records can be searched by LCCN"	"BE_HAVE_MD_QUESTION"
"Where do I go "	"I do not know where you go"	"WQUES"
"Does the website offer function for the hearing impaired "	"I do not know if the website offer function for the hearing impaired"	"DO_QUESTION"
"Do you offer a free trial period on subscriptions"	"I do not know if I offer a free trial period on subscriptions"	"DO_QUESTION"
"What are the different plans you offer for the subscription "	"I do not know what the different plans I offer for the subscription are"	"WQUES"
"Can I copy and paste information into my Grants.gov application from a Microsoft Word document "	"I do not know if you can copy and paste information into your Grants.gov application from a Microsoft Word document"	"BE_HAVE_MD_QUESTION"
"What is a federally recognized tribe "	"I do not know what a recognized tribe is federally"	"WQUES"
"Why would I want to switch to your service "	"I do not know why you would want to switch to my service"	"WQUES"
"How to get proof of retirement or pension income "	"I do not know how to get proof of retirement or pension income"	"WQUES_SIMPLE"
"Does my membership discount apply to books that are on sale "	"I do not know if your membership discount apply to books that are on sale"	"DO_QUESTION"
"I ca n't find the answer to my question "	"I do not know how to handle 'I ca n't find the answer to my question '"	"CANONICAL_IDK"
"If I have n't read the book or seen the movie , will I still have a good time "	"I do not know if you will still have a good time"	"BE_HAVE_MD_QUESTION"
"Why is n't See 's sugar free candy called ' sugar free chocolate ' "	"I do not know why is n't See 's sugar free candy called ' sugar free chocolate '"	"WQUES_SIMPLE"
"How do I know how much data I will need with The Verizon Plan "	"I do not know how you know how much data you will need with The Verizon Plan"	"WQUES"
"My bill seems unusually high this month , can you give me a breakdown of the charges "	"I do not know if I can give you a breakdown of the charges"	"BE_HAVE_MD_QUESTION"
"Why is it necessary to sign in to the XFINITY WiFi app "	"I do not know why it is necessary to sign in to the XFINITY WiFi app"	"WQUES"
"I 'd like an update on this invoice that I have "	"I do not know how to handle 'I 'd like an update on this invoice that I have '"	"CANONICAL_IDK"
"Can you ship my order to a different address than the billing address "	"I do not know if I can ship your order to a different address than the billing address"	"BE_HAVE_MD_QUESTION"
"Are we permitted to take photographs"	"I do not know if you are permitted to take photographs"	"BE_HAVE_MD_QUESTION"
"When I assign or sell a lease or retail installment contract to a third party lender , do I have to give an opt-out notice to my customers "	"I do not know when you assign or sell a lease or retail installment contract to a third party lender"	"WQUES"
"How long is a Schengen visa valid for "	"I do not know how long is a Schengen visa valid for"	"WQUES_SIMPLE"
"How can I become a member or renew my membership "	"I do not know how you can become a member or renew your membership"	"WQUES"
"Do I qualify for a loan forgiveness program "	"I do not know if you qualify for a loan forgiveness program"	"DO_QUESTION"
"Can I set up my PIN number using the mobile app "	"I do not know if you can set up your PIN number using the mobile app"	"BE_HAVE_MD_QUESTION"
"How is my home address used "	"I do not know how your home address is used"	"WQUES"
"Is a pregnant employee or applicant entitled to special treatment "	"I do not know if a pregnant employee or applicant is entitled to special treatment"	"BE_HAVE_MD_QUESTION"
"Do I need to pay nonexempt employees for their lunch break if they eat at their desk "	"I do not know if you need to pay nonexempt employees for their lunch break if they eat at their desk"	"DO_QUESTION"
"I paid for admission to the Zoo , can I apply the cost towards a membership "	"I do not know if you can apply the cost towards a membership"	"BE_HAVE_MD_QUESTION"
"Can I try out a dance class before registering for the full semester "	"I do not know if you can try out a dance class before registering for the full semester"	"BE_HAVE_MD_QUESTION"
"Are salads on the menu"	"I do not know if salads are on the menu"	"BE_HAVE_MD_QUESTION"
"I want to know if a specific item is available to buy online and pick up in store "	"I do not know how to handle 'I want to know if a specific item is available to buy online and pick up in store '"	"CANONICAL_IDK"
"Can I use my cards at other museums "	"I do not know if you can use your cards at other museums"	"BE_HAVE_MD_QUESTION"
"How long does it usually take to learn how to dance "	"I do not know how long it usually takes to learn how to dance"	"WQUES"
"Why does n't upsmon send a SIGPWR signal to init so it can deal with power events "	"I do not know why n't upsmon send a SIGPWR signal to init so it can deal with power events"	"WQUES_SIMPLE"
"Why are there no prices listed on anything in your store "	"I do not know why no prices listed on anything in my store are there"	"WQUES"
"I would like to find out the exchange rate of the total cost of this sale since I am purchasing the items in another country , can you please help me out "	"I do not know if I can help you out"	"BE_HAVE_MD_QUESTION"
"If you use a wall clock to clock in can you clock out online "	"I do not know how to handle 'If you use a wall clock to clock in can you clock out online '"	"CANONICAL_IDK"
"When is the newest version of that graphics card coming out "	"I do not know when is the newest version of that graphics card coming out"	"WQUES_SIMPLE"
"Can I schedule the day you drop off my package "	"I do not know if you can schedule the day I drop off your package"	"BE_HAVE_MD_QUESTION"
"Does your company have an app "	"I do not know if my company have an app"	"DO_QUESTION"
"Can I park my RV in your parking lot overnight "	"I do not know if you can park your RV in my parking lot overnight"	"BE_HAVE_MD_QUESTION"
"Do you offer renters insurance "	"I do not know if I offer renters insurance"	"DO_QUESTION"
"I need to edit my shipping address "	"I do not know how to edit your shipping address"	"IMPERATIVE"
"Does the state run the museum "	"I do not know if the state runs the museum"	"DO_QUESTION"
"When will my first pick up be "	"I do not know when your first pick will up be"	"WQUES"
"Does an employer have to pay its employees overtime if they work the night shift or the graveyard shift "	"I do not know if an employer has to pay its employees overtime if they work the night shift or the graveyard shift"	"DO_QUESTION"
"May I bring guests to the Museum for free with my membership "	"I do not know if you may bring guests to the Museum for free with your membership"	"BE_HAVE_MD_QUESTION"
"Will my visitor pass grant me access to the Memorial and Museum "	"I do not know if your will visitor pass grant you access to the Memorial and Museum"	"BE_HAVE_MD_QUESTION"
"How long is my Member Pass valid "	"I do not know how long your Member Pass is valid"	"WQUES"
"When does the Historic Campus open for the Season "	"I do not know when does the Historic Campus open for the Season"	"WQUES_SIMPLE"
"Will I need to provide my own computer/laptop if I choose to telecommute "	"I do not know if you will need to provide your own computer/laptop if you choose to telecommute"	"BE_HAVE_MD_QUESTION"
"Can i change my shipping address "	"I do not know if you can change your shipping address"	"BE_HAVE_MD_QUESTION"
"Why Do Some Black Cats Look Different in the Sun "	"I do not know why Some Black Cats Look Different in the Sun"	"WQUES"
"I am having trouble verifying my bank account in my Amazon Payments account . Where am I going wrong "	"I do not know where you are going wrong"	"WQUES"
"why is shipping so expensive"	"I do not know why is shipping so expensive"	"WQUES_SIMPLE"
"how much dirt do i need to buy for my garden "	"I do not know how much dirt you need to buy for your garden"	"WQUES"
"I lost something in the museum ! Who do I contact "	"I do not know who you contact"	"WQUES"
"When will my package arrive "	"I do not know when your package will arrive"	"WQUES"
"I keep getting an error message when I try logging in to apply "	"I do not know when you try logging in to apply"	"WQUES"
"Can you tell me what days and hours your satellite office is open for business "	"I do not know if I can tell you what days and hours my satellite office is open for business"	"BE_HAVE_MD_QUESTION"
"When will my product be activated "	"I do not know when your product will be activated"	"WQUES"
"How can I delete my account "	"I do not know how you can delete your account"	"WQUES"
"How is higher education in France organized "	"I do not know how higher education in France is organized"	"WQUES"
"Can I apply for more than one job at a time "	"I do not know if you can apply for more than one job at a time"	"BE_HAVE_MD_QUESTION"
"Where do I go for classes "	"I do not know where you go for classes"	"WQUES"
"How long does the process of returning an item take "	"I do not know how long the process of returning an item takes"	"WQUES"
"How much will it cost to increase my coverage from $ 100,000 to $ 150,000 at the end of this month "	"I do not know how much it will cost to increase your coverage from $ 100,000 to $ 150,000 at the end of this month"	"WQUES"
"Do you accept AmEx as payment"	"I do not know if I accept AmEx as payment"	"DO_QUESTION"
"What is maximum group size for visit and how many adults are required "	"I do not know what is maximum group size for visit and many adults how many adults are required"	"WQUES"
"It looks like refund went to a gift card . But I no longer have that gift card . Could you issue a new one "	"I do not know if I could issue a new one"	"BE_HAVE_MD_QUESTION"
"How to estimate the distance between phone and Nut "	"I do not know how to estimate the distance between phone and Nut"	"WQUES_SIMPLE"
"What social media channels does Kemppi use "	"I do not know what social media channels Kemppi uses"	"WQUES_SIMPLE"
"Will I need to pay tax in my state "	"I do not know if you will need to pay tax in your state"	"BE_HAVE_MD_QUESTION"
"how do i report a fraudulent transaction"	"I do not know how you report a fraudulent transaction"	"WQUES"
"What is the cause of the delay for my package "	"I do not know what the cause of the delay for your package is"	"WQUES"
"I would like to compliment the rep that spoke to me on my last order "	"I do not know how to handle 'I would like to compliment the rep that spoke to me on my last order '"	"CANONICAL_IDK"
"Do I get paid for overtime "	"I do not know if you get paid for overtime"	"DO_QUESTION"
"What day will I need to pay by "	"I do not know what day you will need to pay by"	"WQUES"
"Does an employer in the wholesale and warehouse industries have any specific federal compliance requirements when hiring seasonal employees who are underage "	"I do not know if an employer in the wholesale and warehouse industries has any specific federal compliance requirements when hiring seasonal employees who are underage"	"DO_QUESTION"
"When will you get a new shipment "	"I do not know when I will get a new shipment"	"WQUES"
"I need to finalize my summer plans prior to the notification date . Is it possible to expedite the application review process "	"I do not know if it is possible to expedite the application review process"	"BE_HAVE_MD_QUESTION"
"Snake Bites and Scorpion Stings"	"I do not know how to handle 'Snake Bites and Scorpion Stings'"	"CANONICAL_IDK"
"Where should buses drop-off students and park "	"I do not know where should buses drop-off students and park"	"WQUES_SIMPLE"
"What should my camper bring "	"I do not know what your camper should bring"	"WQUES"
"Can I wear shorts and a T-Shirt in class "	"I do not know if you can wear shorts and a T-Shirt in class"	"BE_HAVE_MD_QUESTION"
"How long does an educational programme last "	"I do not know how long does an educational programme last"	"WQUES_SIMPLE"
"How do I know what jobs are available "	"I do not know how you know what jobs are available"	"WQUES"
"How can I become a member of the Penn Museum "	"I do not know how you can become a member of the Penn Museum"	"WQUES"
"How old was Weyland in this film "	"I do not know how old Weyland was in this film"	"WQUES"
"What guidelines should an employer provide to employees conducting office pools "	"I do not know what guidelines an employer should provide to employees conducting office pools"	"WQUES"
"If I join the Museum in person at the Admissions Desk , will I receive free admission that day "	"I do not know if you will receive free admission that day"	"BE_HAVE_MD_QUESTION"
"Can you throw away old background check information your company has obtained , including application forms and consumer reports "	"I do not know if I can throw away old background check information my company has obtained , including application forms and consumer reports"	"BE_HAVE_MD_QUESTION"
"When an employer hires a remote employee , how should the employer complete the Form I-9 "	"I do not know how the employer When an employer hires a remote employee , should complete the Form I-9"	"WQUES"
"If I return a product , how long does it take for me to get refunded "	"I do not know how long it takes for you to get refunded"	"WQUES"
"Are there hiking trails at the zoo "	"I do not know if there hiking trails are at the zoo"	"BE_HAVE_MD_QUESTION"
"Why was my application not qualified "	"I do not know why your application was not qualified"	"WQUES"
"I would like to know how to sign up for your volunteer service and if I could sign up today "	"I do not know how to sign up for my volunteer service and if you could sign up today"	"WQUES_SIMPLE"
"What kind of art is in the building "	"I do not know what kind of art is in the building"	"WQUES_SIMPLE"
"When applying for a US passport renewal , will my old passport be returned to me "	"I do not know when applying for a you passport renewal your old passport , will be returned to you"	"WQUES"
"Is My service animal permitted in the Museum"	"I do not know if your service animal is permitted in the Museum"	"BE_HAVE_MD_QUESTION"
"How much does it cost to get into the Golisano Children 's Museum of Naples -LRB- C'MON -RRB-"	"I do not know how much it costs to get into the Golisano Children 's Museum of Naples -LRB- C'MON -RRB-"	"WQUES"
"Is the Gallery available for private event rentals "	"I do not know if the Gallery is available for private event rentals"	"BE_HAVE_MD_QUESTION"
"Who determines when a position is properly designated as security/safety sensitive and/or CAAL-covered "	"I do not know who determines when a position is properly designated as security/safety sensitive and/or CAAL-covered"	"WSUBJ"
"What data do I have access to "	"I do not know what data you have access to"	"WQUES"
"Can you see my outstanding balance "	"I do not know if I can see your outstanding balance"	"BE_HAVE_MD_QUESTION"
"Can you please let me know when my subscription renews "	"I do not know if I can let you know when your subscription renews"	"BE_HAVE_MD_QUESTION"
"I received a paper that said my package delivery attempt failed and the package was brought to the post office . However , it did n't say which post office and I live near 3 of them . Where should I go "	"I do not know a paper that said your package delivery attempt failed and the package was brought to the post office you received ."	"WQUES"
"Can I bring my stroller or mobility scooter "	"I do not know if you can bring your stroller or mobility scooter"	"BE_HAVE_MD_QUESTION"
"Is there nearby food and Lodging"	"I do not know if there is nearby food and Lodging"	"BE_HAVE_MD_QUESTION"
"What is the first scene all about "	"I do not know what the first scene all about is"	"WQUES"
"When will you have it available "	"I do not know when I will have it available"	"WQUES"
"Can the museum be observed by the organizer of a tour in advance "	"I do not know if the museum can be observed by the organizer of a tour in advance"	"BE_HAVE_MD_QUESTION"
"i purchase an appliance and I am missing some parts , would you please help me with this issue "	"I do not know if I would help you with this issue"	"BE_HAVE_MD_QUESTION"
"Why did my Youtube account get suspended "	"I do not know why your Youtube account get suspended"	"WQUES"
"Are strollers available at the Zoo "	"I do not know if strollers are available at the Zoo"	"BE_HAVE_MD_QUESTION"
"What is CMA and what can my family do there "	"I do not know what your family can do"	"WQUES"
"Why is there such a long line at the Uffizi "	"I do not know why such a long line is there at the Uffizi"	"WQUES"
"I am scheduled to receive a delivery of groceries tomorrow at noon , but I am no longer going to be home at this time . Can I reschedule it "	"I do not know how to you are scheduled to receive a delivery of groceries tomorrow at"	"IMPERATIVE"
"Where can I find this product "	"I do not know where you can find this product"	"WQUES"
"I got an email saying that my payment method ca n't be verified "	"I do not know how to handle 'I got an email saying that my payment method ca n't be verified '"	"CANONICAL_IDK"
"I want to customize by handbag and I want to know how should I proceed further "	"I do not know how you should proceed"	"WQUES"
"How do I apply for a CDL in Texas "	"I do not know how you apply for a CDL in Texas"	"WQUES"
"Can you send me feathers or other items from an animal "	"I do not know if I can send you feathers or other items from an animal"	"BE_HAVE_MD_QUESTION"
"Q -- What is Gift Aid"	"I do not know what Gift Aid is"	"WQUES"
"What if I already have employment agreements with my employees "	"I do not know what you if already have employment agreements with your employees"	"WQUES"
"Where are the bears "	"I do not know where the bears are"	"WQUES"
"How can I prepare for the test "	"I do not know how you can prepare for the test"	"WQUES"
"Can I have visitors "	"I do not know if you can have visitors"	"BE_HAVE_MD_QUESTION"
"What is the weather like at different times of year "	"I do not know what the weather like at different times of year is"	"WQUES"
"Does the lawn pass include access to MYSTERYLAND USA"	"I do not know if the lawn pass includes access to MYSTERYLAND USA"	"DO_QUESTION"
"How long does it take for an insurance quote to arrive once I 've submitted my application form with all my information to your website "	"I do not know how long it takes for an insurance quote to arrive once you 've submitted your application form with all your information to my website"	"WQUES"
"The sales clerk assured me that assembly was included in the final price , but the delivery driver is saying that it is additional , can you please resolve this issue "	"I do not know if I can resolve this issue"	"BE_HAVE_MD_QUESTION"
"What is parallelism "	"I do not know what parallelism is"	"WQUES"
"Do we have to have a formal referral to get an assessment"	"I do not know if you have to have a formal referral to get an assessment"	"DO_QUESTION"
"When can I change my address information if I plan on moving apartments within the next week "	"I do not know when you can change your address information if you plan on moving apartments within the next week"	"WQUES"
"Can I get a discount at your hotel for staying for a longer period of time "	"I do not know if you can get a discount at my hotel for staying for a longer period of time"	"BE_HAVE_MD_QUESTION"
"I did n't know this case of pasta dishes required adding eggs . Can you please either send eggs or help me exchange it "	"I do not know if I can either send eggs or help you exchange it"	"BE_HAVE_MD_QUESTION"
"I need to book a cruise to the Bahamas . Can you please connect me with an agent "	"I do not know how to book a cruise to the Bahamas ."	"IMPERATIVE"
"Could I replace a broken item "	"I do not know if you could replace a broken item"	"BE_HAVE_MD_QUESTION"
"On what date are you offering the new model for sale to the public "	"I do not know how to handle 'On what date are you offering the new model for sale to the public '"	"CANONICAL_IDK"
"What do I do if my package was stolen "	"I do not know what you do if your package was stolen"	"WQUES"
"Can I get insurance for my kids under Obamacare and pay the tax for myself "	"I do not know if you can get insurance for your kids under Obamacare and pay the tax for yourself"	"BE_HAVE_MD_QUESTION"
"I forgot my PIN number"	"I do not know how to handle 'I forgot my PIN number'"	"CANONICAL_IDK"
"What is the Caregiver Option "	"I do not know what the Caregiver Option is"	"WQUES"
"How can get a refund on a defective product that is no longer working properly ? I ordered this awhile ago"	"I do not know how can get a refund on a defective product that is no longer working properly"	"WQUES_SIMPLE"
"Do you offer a military discount "	"I do not know if I offer a military discount"	"DO_QUESTION"
"I need to change my payment information "	"I do not know how to change your payment information"	"IMPERATIVE"
"How does someone who holds two positions at the college enter their time "	"I do not know how does someone who holds two positions at the college enter their time"	"WQUES_SIMPLE"
"Can I clean my Staub products in the dishwasher "	"I do not know if you can clean your Staub products in the dishwasher"	"BE_HAVE_MD_QUESTION"
"What is the Freedom of Access Act "	"I do not know what the Freedom of Access Act is"	"WQUES"
"If I purchase the Professional edition , ' Unlimited ' license for the HEVC encoder , am I allowed to redistribute unlimited copies of our company 's apps . Does this also apply to internal sockets for unlimited use "	"I do not know how to ' Unlimited ' license for the HEVC encoder , am you allowed to redistribute unlimited copies of your company 's apps ."	"IMPERATIVE"
"Can you tell me what payment method I have on file "	"I do not know if I can tell you what payment method you have on file"	"BE_HAVE_MD_QUESTION"
"Can I become a certified user without a California DMV license "	"I do not know if you can become a certified user without a California DMV license"	"BE_HAVE_MD_QUESTION"
"Will the new Berkshire Museum be handicapped accessible "	"I do not know if the new Berkshire Museum will be handicapped accessible"	"BE_HAVE_MD_QUESTION"
"What items are not eligible for Shipped by Newegg "	"I do not know what items are not eligible for Shipped by Newegg"	"WQUES_SIMPLE"
"What kind of services do you offer after the sale "	"I do not know what kind of services I offer after the sale"	"WQUES"
"Can I view the Assembly Rooms as part of my visit "	"I do not know if you can view the Assembly Rooms as part of your visit"	"BE_HAVE_MD_QUESTION"
"Do you have this in a larger size "	"I do not know if I have this in a larger size"	"DO_QUESTION"
"Can a registered domestic partner qualify to file his or her tax return using head-of-household filing status "	"I do not know if a registered domestic partner can qualify to file his or her tax return using head-of-household filing status"	"BE_HAVE_MD_QUESTION"
"How should registered domestic partners report community income from a business on Schedule C , Profit or Loss From Business "	"I do not know how should registered domestic partners report community income from a business on Schedule C , Profit or Loss From Business"	"WQUES_SIMPLE"
"What types of classes do you offer "	"I do not know what types of classes I offer"	"WQUES"
"What if I am unhappy with the product I receive"	"I do not know what if you are unhappy with the product you receive"	"WQUES_SIMPLE"
"Do I need Ballet experience to participate in Barre "	"I do not know if you need Ballet experience to participate in Barre"	"DO_QUESTION"
"Is there a fee for canceling an appointment at the last minute "	"I do not know if there is a fee for canceling an appointment at the last minute"	"BE_HAVE_MD_QUESTION"
"What if I receive another tax form after I 've filed my return "	"I do not know what you if receive another tax form after you 've filed your return"	"WQUES"
"For purposes of recouping a wage overpayment , is there a dollar amount that is considered too small to be worth recouping "	"I do not know how to for purposes of recouping a wage"	"IMPERATIVE"
"Can you send me the tracking number for the item I purchased "	"I do not know if I can send you the tracking number for the item you purchased"	"BE_HAVE_MD_QUESTION"
"Can you update my credit card information on file so my subscription will automatically renew "	"I do not know if I can update your credit card information on file so your subscription will automatically renew"	"BE_HAVE_MD_QUESTION"
"Do you have any artificial christmas trees in stock "	"I do not know if I have any artificial christmas trees in stock"	"DO_QUESTION"
"How do I make a reservation for a class"	"I do not know how you make a reservation for a class"	"WQUES"
"What if I have questions along the way "	"I do not know what you if have questions along the way"	"WQUES"
"Ordering articles with Blue Credits"	"I do not know how to ordering articles with Blue Credits"	"IMPERATIVE"
"When will these changes become effective "	"I do not know when these changes will become effective"	"WQUES"
"Where do I designate flight search preferences "	"I do not know where you designate flight search preferences"	"WQUES"
"Is there an after hours number that I can call for customer service if I have further problems "	"I do not know if there is an after hours number that you can call for customer service if you have further problems"	"BE_HAVE_MD_QUESTION"
"What happens if I answer my security questions incorrectly "	"I do not know what happens if you answer your security questions incorrectly"	"WSUBJ"
"How long does the process take to become a volunteer"	"I do not know how long the process takes to become a volunteer"	"WQUES"
"Is the interest amount that we paid to the IRS deductible "	"I do not know if the interest amount that is you paid to the IRS deductible"	"BE_HAVE_MD_QUESTION"
"Are there special viewing opportunities for members "	"I do not know if there special viewing opportunities are for members"	"BE_HAVE_MD_QUESTION"
"How do I register my employees for an in-company course "	"I do not know how you register your employees for an in-company course"	"WQUES"
"How long is my password valid "	"I do not know how long your password is valid"	"WQUES"
"Can I schedule a payment arrangement "	"I do not know if you can schedule a payment arrangement"	"BE_HAVE_MD_QUESTION"
"Are there any insurance plans I can get that have a bundle coverage for car & property "	"I do not know if there are any insurance plans you can get that have a bundle coverage for car & property"	"BE_HAVE_MD_QUESTION"
"I am having an issue reaching my Reseller , what should I do "	"I do not know what you should do"	"WQUES"
"I have friends who are also booking packages . Can I make room proximity requests to be located near them at our resort"	"I do not know friends who are also booking packages you have ."	"WQUES"
"How old do I need to be to volunteer "	"I do not know how old you need to be to volunteer"	"WQUES"
"What are the benefits of direct deposit for the university "	"I do not know what the benefits of direct deposit for the university are"	"WQUES"
"When are you going to ship out the product "	"I do not know when I am going to ship out the product"	"WQUES"
"Do I receive free parking with my membership "	"I do not know if you receive free parking with your membership"	"DO_QUESTION"
"What is the amount of an education award "	"I do not know what the amount of an education award is"	"WQUES"
"Which ACCURIDE slides can be mounted on the bottom of the drawer"	"I do not know which ACCURIDE slides can be mounted on the bottom of the drawer"	"WQUES_SIMPLE"
"What are the performance opportunities "	"I do not know what the performance opportunities are"	"WQUES"
"Can my sister pick up my purchase for me "	"I do not know if your sister can pick up your purchase for you"	"BE_HAVE_MD_QUESTION"
"Will I be allowed to change the size of my race singlet during the race entry pack collection -LRB- REPC -RRB-"	"I do not know if you will be allowed to change the size of your race singlet during the race entry pack collection -LRB- REPC -RRB-"	"BE_HAVE_MD_QUESTION"
"How much do you charge for shipping "	"I do not know how much I charge for shipping"	"WQUES"
"What do I get when I become a founding member "	"I do not know what you get when you become a founding member"	"WQUES"
"Where can I go for lunch "	"I do not know where you can go for lunch"	"WQUES"
"Does the Museum have a cafeteria "	"I do not know if the Museum has a cafeteria"	"DO_QUESTION"
"Do you have a senior citizen discount "	"I do not know if I have a senior citizen discount"	"DO_QUESTION"
"I cancelled my order a few minutes ago but changed my mind , can I un-cancel it "	"I do not know if you can un-cancel it"	"BE_HAVE_MD_QUESTION"
"Can I fax it in "	"I do not know if you can fax it in"	"BE_HAVE_MD_QUESTION"
"I need to return a gift I received from your company . What is the address to mail back a return "	"I do not know what the address to mail back a return is"	"WQUES"
"There is a lot that I need to type to fill in my profile . Can it be done for me "	"I do not know if it can be done for you"	"BE_HAVE_MD_QUESTION"
"If a former employee has not paid back an outstanding travel advance received before he or she separated from employment , should the employer include the advance in the former employee 's taxable income "	"I do not know if the employer should include the advance in the former employee 's taxable income"	"BE_HAVE_MD_QUESTION"
"Do I need anything besides a Minecraft : Education Edition license to play "	"I do not know if you need anything besides a Minecraft : Education Edition license to play"	"DO_QUESTION"
"Who is Eric Carle "	"I do not know who Eric Carle is"	"WQUES"
"I ordered too many items , may I have one taken of please "	"I do not know if you may have one taken of"	"BE_HAVE_MD_QUESTION"
"What types of art will I see at the Hunter"	"I do not know what types of art you will see at the Hunter"	"WQUES"
"What will the curators and museum staff do while the museum is closed "	"I do not know what the curators and museum staff will museum staff do while the museum is closed"	"WQUES"
"Do you know when my package will arrive "	"I do not know if I know when your package will arrive"	"DO_QUESTION"
"Will I be the only adult "	"I do not know if you will be the only adult"	"BE_HAVE_MD_QUESTION"
"Is it tough to work in FREETREND 's overseas factories "	"I do not know if it is tough to work in FREETREND 's overseas factories"	"BE_HAVE_MD_QUESTION"
"How many devices can I have on the new Verizon Plan Unlimited "	"I do not know how many devices you can have on the new Verizon Plan Unlimited"	"WQUES"
"Will I have enough time with a 9:30 ticket"	"I do not know if you will have enough time with a 9:30 ticket"	"BE_HAVE_MD_QUESTION"
"When does the East Bay Plaza stream open "	"I do not know when does the East Bay Plaza stream open"	"WQUES_SIMPLE"
"Can I do this on your website "	"I do not know if you can do this on my website"	"BE_HAVE_MD_QUESTION"
"Can I get a signed permission form from NARA to use materials "	"I do not know if you can get a signed permission form from NARA to use materials"	"BE_HAVE_MD_QUESTION"
"Does CCDS have annual recitals "	"I do not know if ccds have annual recitals"	"DO_QUESTION"
"What should we bring "	"I do not know what you should bring"	"WQUES"
"I need to find a new car , can you recommend a dealer "	"I do not know how to find a new"	"IMPERATIVE"
"Which years are associated with a particular Congress "	"I do not know which years are associated with a particular Congress"	"WQUES_SIMPLE"
"What package has the most channels "	"I do not know what package has the most channels"	"WQUES_SIMPLE"
"I would like to have a Zcar at my home at 2822 Black Oak , Tampa FL on Wednesday , August 29th at 4 pm "	"I do not know if a have Zcar at your home at 2822 Black Oak , Tampa FL on Wednesday , August 29th at 4 pm"	"BE_HAVE_MD_QUESTION"
"What do I need to know about the information I submit "	"I do not know what you need to know about the information you submit"	"WQUES"
"When can I expect my refund to be deposited into my account ? It 's been 2 weeks "	"I do not know when you can expect your refund to be deposited into your account"	"WQUES"
"Can I request faster shipping "	"I do not know if you can request faster shipping"	"BE_HAVE_MD_QUESTION"
"How long does it take to send a large parcel from Pittsburgh to Denver , Colorado "	"I do not know how long it takes to send a large parcel from Pittsburgh to Denver , Colorado"	"WQUES"
"Do you charge extra if the table needs to be releveled at a later date "	"I do not know if I charge extra if the table needs to be releveled at a later date"	"DO_QUESTION"
"Can you help me ? I can not access my online account"	"I do not know if I can help you"	"BE_HAVE_MD_QUESTION"
"How do I get payroll to change my name "	"I do not know how you get payroll to change your name"	"WQUES"
"Do you ship to P.O Boxes "	"I do not know if I ship to P.O Boxes"	"DO_QUESTION"
"ShowWhat do I do during practical "	"I do not know how to handle 'ShowWhat do I do during practical '"	"CANONICAL_IDK"
"How do I find information on the new HR Website "	"I do not know how you find information on the new HR Website"	"WQUES"
"I subscribed to your gaming magazine and got charged twice for my subscription . How can I get a refund for the over charge "	"I do not know how you can get a refund for the over charge"	"WQUES"
"How many servings from each food group do I need each day "	"I do not know how many servings from each food group you need each day"	"WQUES"
"Could I request a refund on the credit in my invoice "	"I do not know if you could request a refund on the credit in your invoice"	"BE_HAVE_MD_QUESTION"
"I need to return an order , but ca n't find how to do so , can you help me "	"I do not know return an order , but ca n't find how to do so I ca n't find how to do so , can help you"	"WQUES"
"Is there accessible seating "	"I do not know if there is accessible seating"	"BE_HAVE_MD_QUESTION"
"I work nights and will be too tired to serve jury duty . Do I have to serve "	"I do not know if you have to serve"	"DO_QUESTION"
"Can I get my court fees waived "	"I do not know if you can get your court fees waived"	"BE_HAVE_MD_QUESTION"
"Is the watch waterproof"	"I do not know if the watch is waterproof"	"BE_HAVE_MD_QUESTION"
"Who should I contact if I have a question about my superannuation "	"I do not know who you should contact if you have a question about your superannuation"	"WQUES"
"What is the cost for adult supervisors "	"I do not know what the cost for adult supervisors is"	"WQUES"
"What or Who is Zohar "	"I do not know what Zohar is"	"WQUES"
"Why does it say print ' tickets ' when I purchased a membership "	"I do not know why it says print ' tickets ' when you purchased a membership"	"WQUES"
"Is it possible to arrange a guided group visit to the Anne Frank House "	"I do not know if it is possible to arrange a guided group visit to the Anne Frank House"	"BE_HAVE_MD_QUESTION"
"What shipping service do you use"	"I do not know what shipping service I use"	"WQUES"
"Is Gst included in the registration fees"	"I do not know if gst is included in the registration fees"	"BE_HAVE_MD_QUESTION"
"Would their be an extra cost for a larger size "	"I do not know if their would be an extra cost for a larger size"	"BE_HAVE_MD_QUESTION"
"Can I get a replacement for a defective product "	"I do not know if you can get a replacement for a defective product"	"BE_HAVE_MD_QUESTION"
"What are Indian treaty rights "	"I do not know what Indian treaty rights are"	"WQUES"
"Can I get a membership to the Zoo "	"I do not know if you can get a membership to the Zoo"	"BE_HAVE_MD_QUESTION"
"How has the museum evolved from its inception "	"I do not know how the museum has evolved from its inception"	"WQUES"
"How can I volunteer "	"I do not know how you can volunteer"	"WQUES"
"What is the Museum 's cancellation policy for events "	"I do not know what the Museum 's cancellation policy for events is"	"WQUES"
"Will there be an annual dance recital "	"I do not know if there will be an annual dance recital"	"BE_HAVE_MD_QUESTION"
"What is dependent eligibility verification "	"I do not know what dependent eligibility verification is"	"WQUES"
"I needed to update some information on my account "	"I do not know how to update some information on your account"	"IMPERATIVE"
"When is the best time of day to visit ZooLights "	"I do not know when the best time of day to visit ZooLights is"	"WQUES"
"I am looking for information on traveling with a frozen turkey to Israel , can you help me "	"I do not know if I can help you"	"BE_HAVE_MD_QUESTION"
"Where is the Members ' Cloakroom "	"I do not know where the Members ' Cloakroom is"	"WQUES"
"Did Neil Armstrong still live in Wapakoneta "	"I do not know if Neil Armstrong still lived in Wapakoneta"	"DO_QUESTION"
"How does registration work "	"I do not know how does registration work"	"WQUES_SIMPLE"
"what does it mean if an item is final sale"	"I do not know what it means if an item is final sale"	"WQUES"
"How do the changes to the policies revised under CALM affect unionized employees "	"I do not know how the changes to the policies revised under CALM affect unionized employees"	"WQUES"
"What is cyberbullying in the workplace "	"I do not know what is cyberbullying in the workplace"	"WSUBJ"
"Is smoking or vaping permitted in the Zoo "	"I do not know if smoking or vaping is permitted in the Zoo"	"BE_HAVE_MD_QUESTION"
"What policies are being revised and when will the new policies become effective "	"I do not know when the new policies will become effective"	"WQUES"
"How long is the night walk"	"I do not know how long the night is walk"	"WQUES"
"Are there designated smoking areas in the Zoo "	"I do not know if there designated smoking areas are in the Zoo"	"BE_HAVE_MD_QUESTION"
"What do dancers eat "	"I do not know what dancers eat"	"WQUES_SIMPLE"
"Does MGM Grand offer parking for hotel guests "	"I do not know if MGM Grand offer parking for hotel guests"	"DO_QUESTION"
"May I take photos in the museum "	"I do not know if you may take photos in the museum"	"BE_HAVE_MD_QUESTION"
"Within how many minutes after placing an order can I cancel "	"I do not know within how many minutes after placing an order you can cancel"	"WQUES"
"How can I visit the Treasure Gallery "	"I do not know how you can visit the Treasure Gallery"	"WQUES"
"My service was supposed to start yesterday and it 's still not working , help "	"I do not know how to help"	"IMPERATIVE"
"Where can I find your license agreements "	"I do not know where you can find my license agreements"	"WQUES"
"Who is required to have a CDL in Texas "	"I do not know who to have a CDL in Texas Who is required"	"WQUES"
"Can we take pictures and videos"	"I do not know if you can take pictures and videos"	"BE_HAVE_MD_QUESTION"
"Are there any restaurants in the Museum"	"I do not know if there are any restaurants in the Museum"	"BE_HAVE_MD_QUESTION"
"Has Treasury ever redeemed existing investments and suspended new investments in the CSRDF before "	"I do not know if Treasury has ever redeemed existing investments and suspended new investments in the CSRDF before"	"BE_HAVE_MD_QUESTION"
"What is Blue Star Museums "	"I do not know what Blue Star Museums is"	"WQUES"
"What ages of students do you teach "	"I do not know what ages of students I teach"	"WQUES"
"Do you provide a receipt for the car reservation "	"I do not know if I provide a receipt for the car reservation"	"DO_QUESTION"
"Who can I contact to make sure that my catalog is going to be able to get to my house when I move "	"I do not know who you can contact to make sure that your catalog is going to be able to get to your house when you move"	"WQUES"
"What can my employer do to my mobile device "	"I do not know what your employer can do to your mobile device"	"WQUES"
"They attempted to deliver my package to my home , but I need it delivered to work instead "	"I do not know how to handle 'They attempted to deliver my package to my home , but I need it delivered to work instead '"	"CANONICAL_IDK"
"I heard you are now offering more discount on product X , Could you please let me know if I am eligible "	"I do not know if I could let you know if you are eligible"	"BE_HAVE_MD_QUESTION"
"Is there a list of collection works presently on view at the Museum "	"I do not know if there is a list of collection works presently on view at the Museum"	"BE_HAVE_MD_QUESTION"
"Would it be possible to add onto my order before it ships and receive all my items at the same time as originally scheduled "	"I do not know if it would be possible to add onto your order before it ships and receive all your items at the same time as originally scheduled"	"BE_HAVE_MD_QUESTION"
"I saw the shirt I bought go on sale today - would I be able to get a refund for the sale price "	"I do not know if you would be able to get a refund for the sale price"	"BE_HAVE_MD_QUESTION"
"What is the process for refinancing my home "	"I do not know what the process for refinancing your home is"	"WQUES"
"Does Brevard Zoo have automatic tellers -LRB- ATMs -RRB- "	"I do not know if Brevard Zoo has automatic tellers -LRB- ATMs -RRB-"	"DO_QUESTION"
"Could you please send me a payment record of my last year 's payments "	"I do not know if I could send you a payment record of your last year 's payments"	"BE_HAVE_MD_QUESTION"
"Can ESS be viewed by people who have left the University "	"I do not know if ESS can be viewed by people who have left the University"	"BE_HAVE_MD_QUESTION"
"How do I repair a phone that was damaged by water "	"I do not know how you repair a phone that was damaged by water"	"WQUES"
"What are the hospital visiting hours & policies "	"I do not know what the hospital visiting hours & policies are"	"WQUES"
"Can you pause my subscription for this month while i 'm traveling "	"I do not know if I can pause your subscription for this month while you are traveling"	"BE_HAVE_MD_QUESTION"
"How do I get my package to FedEx "	"I do not know how you get your package to FedEx"	"WQUES"
"How to obtain a visa "	"I do not know how to obtain a visa"	"WQUES_SIMPLE"
"Why is there an admission charge "	"I do not know why an admission charge is there"	"WQUES"
"The bank sent me someone elses statement , can you tell me who to call "	"I do not know the bank sent you someone elses statement , can I tell you who to call"	"WSUBJ"
"What are the naming conventions for passwords "	"I do not know what the naming conventions for passwords are"	"WQUES"
"What are the Museum 's hours of operation "	"I do not know what the Museum 's hours of operation are"	"WQUES"
"do you rent equipment "	"I do not know if I rent equipment"	"DO_QUESTION"
"Are refrigerators available "	"I do not know if refrigerators are available"	"BE_HAVE_MD_QUESTION"
"Who can help me with selecting a new service "	"I do not know who can help you with selecting a new service"	"WSUBJ"
"May an employee bring a pay discrimination claim on grounds other than sex "	"I do not know if an employee may bring a pay discrimination claim on grounds other than sex"	"BE_HAVE_MD_QUESTION"
"I booked a flight to Australia and I would like to know how much weight I can carry in my handbag and main language"	"I do not know you would like to know how much weight you can carry in your handbag and main language you booked a flight to Australia and"	"WQUES"
"How do I go about change the scheduled pickup for these packages I wanted to have collected at some point "	"I do not know how you go about change the scheduled pickup for these packages you wanted to have collected at some point"	"WQUES"
"My daughter has been going on my computer and ordering things on my account without my permission . Is there a way I can put a lock on my account or have it ask more identifying questions when making a purchase "	"I do not know if there is a way you can put a lock on your account or have it ask more identifying questions when making a purchase"	"BE_HAVE_MD_QUESTION"
"Can Kaba time clocks be used off Campus "	"I do not know if Kaba time clocks can be used off Campus"	"BE_HAVE_MD_QUESTION"
"Want information on museum events and lectures "	"I do not know how to want information on museum events and lectures"	"IMPERATIVE"
"What is the minimum purchase amount to get free shipping "	"I do not know what the minimum purchase amount to get free shipping is"	"WQUES"
"What kind of monthly plans do you have with data coverage "	"I do not know what kind of monthly plans I have with data coverage"	"WQUES"
"Where is your company located "	"I do not know where my company is located"	"WQUES"
"I have n't received my tracking number yet "	"I do not know how to handle 'I have n't received my tracking number yet '"	"CANONICAL_IDK"
"Please help me track my shipping "	"I do not know how to handle 'Please help me track my shipping '"	"CANONICAL_IDK"
"Can I make an appointment "	"I do not know if you can make an appointment"	"BE_HAVE_MD_QUESTION"
"Can I come pick this up instead of having it shipped to me "	"I do not know if you can come pick this up instead of having it shipped to you"	"BE_HAVE_MD_QUESTION"
"We 're supposed to check-in today , but we are stuck in our car in a flood , what should I do with our room "	"I do not know what you should do with your room"	"WQUES"
"I just registered but made a mistake on some information I put in when registering . Can I change this somehow "	"I do not know you made a mistake on some information you put in when registering you just registered but ."	"WQUES"
"How long does shipping take "	"I do not know how long shipping takes"	"WQUES_SIMPLE"
"What are the differences in the shipping prices and days "	"I do not know what the differences in the shipping prices and days are"	"WQUES"
"Do you offer any warranties "	"I do not know if I offer any warranties"	"DO_QUESTION"
"The provost office currently provides oversight for A&P faculty . Will that change with University Staff "	"I do not know if that will change with University Staff"	"BE_HAVE_MD_QUESTION"
"I am interested in ordering custom order desk from your company . Mr. Pit recommended you highly . Could you tell me from what kind of option can I choose "	"I do not know if I could tell you from what kind of option can you choose"	"BE_HAVE_MD_QUESTION"
"I need to know if you have an opening for friday morning , I have an wedding to go that evening "	"I do not know how to handle 'I need to know if you have an opening for friday morning , I have an wedding to go that evening '"	"CANONICAL_IDK"
"Are there any rules for playing purchased Hollywood movies "	"I do not know if there are any rules for playing purchased Hollywood movies"	"BE_HAVE_MD_QUESTION"
"What if I get more than one bill "	"I do not know what you if get more than one bill"	"WQUES"
"What is included in the ticket price"	"I do not know what is included in the ticket price"	"WQUES_SIMPLE"
"Why has my honey become so thick and granular -LRB- crystallized -RRB- "	"I do not know why your honey has become so thick and granular -LRB- crystallized -RRB-"	"WQUES"
"What are the alternate forms of authorization when I can not be present to sign for my shipment "	"I do not know what the alternate forms of authorization are"	"WQUES"
"Can I order bulk gift cards at a discount "	"I do not know if you can order bulk gift cards at a discount"	"BE_HAVE_MD_QUESTION"
"Can I change my tickets after purchasing them "	"I do not know if you can change your tickets after purchasing them"	"BE_HAVE_MD_QUESTION"
"Do current or former employees have a right to access their personnel records in order to inspect , copy or dispute the information "	"I do not know if current or former employees have a right to access their personnel records in order to inspect , copy or dispute the information"	"DO_QUESTION"
"What types of hospitals are eligible for Medicare EHR incentive payments "	"I do not know what types of hospitals are eligible for Medicare EHR incentive payments"	"WQUES_SIMPLE"
"Can you custom make orders "	"I do not know if I custom can make orders"	"BE_HAVE_MD_QUESTION"
"How do I find the zoo "	"I do not know how you find the zoo"	"WQUES"
"Do you have a newsletter with updates about the Museum "	"I do not know if I have a newsletter with updates about the Museum"	"DO_QUESTION"
"How do I find out when my court date is "	"I do not know how you find out when your court date is"	"WQUES"
"What 's the deal with the insane shipping costs "	"I do not know what the deal with the insane shipping costs 's"	"WQUES"
"I need a copy of my statement "	"I do not know how to a copy of your statement"	"IMPERATIVE"
"I need to route half of my baggage to a different destination so it can wait for me when I get there next week , how can I do that "	"I do not know how route half of your baggage to a different destination so it can wait for you when you get there next week , can you do that"	"WQUES"
"What should an academic year employee do in Workday during the summer "	"I do not know what an academic year employee should do in Workday during the summer"	"WQUES"
"Does copyright protect architecture "	"I do not know if copyright protects architecture"	"DO_QUESTION"
"Where can I mail my payment "	"I do not know where you can mail your payment"	"WQUES"
"How do I apply for 2018 "	"I do not know how you apply for 2018"	"WQUES"
"What are your Group Prices "	"I do not know what my Group Prices are"	"WQUES"
"Who owns the National Park "	"I do not know who owns the National Park"	"WSUBJ"
"What is Cinpolis Junior"	"I do not know what Cinpolis Junior is"	"WQUES"
"Do you offer shipping to Jamaica "	"I do not know if I offer shipping to Jamaica"	"DO_QUESTION"
"Can I bring a bicycle or roller-blade "	"I do not know if you can bring a bicycle or roller-blade"	"BE_HAVE_MD_QUESTION"
"Where can I find the store nearest to me"	"I do not know where you can find the store nearest to you"	"WQUES"
"What information do I need before I start a Marketplace application "	"I do not know what information you need before you start a Marketplace application"	"WQUES"
"I need to change my pick up request I have for tomorrow for another time as I wo n't be around to collect the package"	"I do not know how to handle 'I need to change my pick up request I have for tomorrow for another time as I wo n't be around to collect the package'"	"CANONICAL_IDK"
"Are baby strollers allowed inside the Penn Museum "	"I do not know if baby strollers are allowed inside the Penn Museum"	"BE_HAVE_MD_QUESTION"
"What does a Nashville Zoo membership include"	"I do not know what a Nashville Zoo membership includes"	"WQUES"
"Do I need a visa to visit Panama "	"I do not know if you need a visa to visit Panama"	"DO_QUESTION"
"I travel to Mexico and Canada a lot , so can I use my phone like I do at home "	"I do not know how to handle 'I travel to Mexico and Canada a lot , so can I use my phone like I do at home '"	"CANONICAL_IDK"
"I would like to make a new account with you guys "	"I do not know how to make a new account with me guys"	"IMPERATIVE"
"Who can I contact if I need help or special assistance in completing my application "	"I do not know who you can contact if you need help or special assistance in completing your application"	"WQUES"
"What do I need to bring to be able to check-in "	"I do not know what you need to bring to be able to check-in"	"WQUES"
"What if my income exceeds the $ 130,000 maximum , can I still apply "	"I do not know what you if your income exceeds the $ 130,000 maximum , can still apply"	"WQUES"
"Does your company use fair trade resources "	"I do not know if my company use fair trade resources"	"DO_QUESTION"
"What information will I get from my account manager in my initial call or email "	"I do not know what information you will get from your account manager in your initial call or email"	"WQUES"
"I 'm wanting a different color then what I ordered yesterday , Is it too late to change it "	"I do not know what you ordered yesterday"	"WQUES"
"What are some ways to protect outdoor workers from the heat "	"I do not know what some ways to protect outdoor workers from the heat are"	"WQUES"
"How do I obtain an employment application "	"I do not know how you obtain an employment application"	"WQUES"
"What does it mean if my order status says processing"	"I do not know what it means if your order status says processing"	"WQUES"
"Are there Armed Forces discounts "	"I do not know if there are Armed Forces discounts"	"BE_HAVE_MD_QUESTION"
"How many pieces are in the collection "	"I do not know how many pieces are in the collection"	"WQUES_SIMPLE"
"How do I join Choice Privileges "	"I do not know how you join Choice Privileges"	"WQUES"
"Can I sketch in the museum "	"I do not know if you can sketch in the museum"	"BE_HAVE_MD_QUESTION"
"Why do you recommend appointments "	"I do not know why I recommend appointments"	"WQUES"
"Where on your site can I find the refund policy "	"I do not know where on my site you can find the refund policy"	"WQUES"
"It 's been a week and it seems like the order has n't shipped yet . When can I expect it to ship "	"I do not know when you can expect it to ship"	"WQUES"
"Should registered domestic partners report social security benefits as community income for federal tax purposes "	"I do not know how to handle 'Should registered domestic partners report social security benefits as community income for federal tax purposes '"	"CANONICAL_IDK"
"Is there a ist of store locations that carry this specific product "	"I do not know if there is a ist of store locations that carry this specific product"	"BE_HAVE_MD_QUESTION"
"Where is the museum located "	"I do not know where the museum is located"	"WQUES"
"Is there a museum cafe "	"I do not know if there is a museum cafe"	"BE_HAVE_MD_QUESTION"
"Will being an organ donor affect my medical care "	"I do not know how to will being an organ donor affect your medical care"	"IMPERATIVE"
"May an employer ask an employee if she is pregnant or plans to start a family "	"I do not know if an employer may ask an employee if she is pregnant or plans to start a family"	"BE_HAVE_MD_QUESTION"
"Can I purchase membership as a gift for someone else "	"I do not know if you can purchase membership as a gift for someone else"	"BE_HAVE_MD_QUESTION"
"Can you check if my payment go through "	"I do not know if I can check if your payment go through"	"BE_HAVE_MD_QUESTION"
"Is there someone I can call or email to follow up on my application status "	"I do not know if there is someone you can call or email to follow up on your application status"	"BE_HAVE_MD_QUESTION"
"What is a publicly available , viewable , and bookable rate "	"I do not know what a available , viewable , and bookable rate is publicly"	"WQUES"
"What are differences in research nature between the two fields : Machine Learning & Data Mining "	"I do not know what differences in research nature between the two fields are"	"WQUES"
"What purpose do they serve "	"I do not know what purpose they serve"	"WQUES"
"How is food digested "	"I do not know how food is digested"	"WQUES"
"What is Your Class Refund Policy"	"I do not know what my Class Refund Policy is"	"WQUES"
"How can I recognize an abusive tax avoidance transaction "	"I do not know how you can recognize an abusive tax avoidance transaction"	"WQUES"
"Can I add my child onto my auto insurance policy if he only drives to and from work "	"I do not know if you can add your child onto your auto insurance policy if he only drives to and from work"	"BE_HAVE_MD_QUESTION"
"Do all those texts cost money "	"I do not know if all those texts cost money"	"DO_QUESTION"
"How do I sell tickets for my show "	"I do not know how you sell tickets for your show"	"WQUES"
"What is SMoCA Lounge "	"I do not know what SMoCA Lounge is"	"WQUES"
"Can DanceStudio-Pro handle my tuition "	"I do not know if DanceStudio-Pro can handle your tuition"	"BE_HAVE_MD_QUESTION"
"What types of items qualify as school supplies "	"I do not know what types of items qualify as school supplies"	"WQUES_SIMPLE"
"I 'm not sure which item I want to buy . How can I find out more about them "	"I do not know how you can find out more about them"	"WQUES"
"I would like to alter some details on my account "	"I do not know how to alter some details on your account"	"IMPERATIVE"
"Do the reporting requirements under Section 6056 apply to nonprofit and government employers "	"I do not know if the reporting requirements under Section 6056 apply to nonprofit and government employers"	"DO_QUESTION"
"How do I attach my resume , cover letter , or other documents "	"I do not know how you attach your resume , cover letter , or other documents"	"WQUES"
"Is the information sent through the My Verizon app secure "	"I do not know if the information is sent through the your Verizon app secure"	"BE_HAVE_MD_QUESTION"
"I like to plan ahead . Can I purchase tickets before I get there "	"I do not know how to plan ahead ."	"IMPERATIVE"
"How do I begin using the migration tool "	"I do not know how you begin using the migration tool"	"WQUES"
"Do I also need to wait in line if I have a Museum Card "	"I do not know if you also need to wait in line if you have a Museum Card"	"DO_QUESTION"
"Where are facilities available for diaper changing "	"I do not know where facilities available for diaper changing are"	"WQUES"
"What is my account number "	"I do not know what your account number is"	"WQUES"
"When does the credited amount expire if at all "	"I do not know when the credited amount expires if at all"	"WQUES"
"Do you accept payment through PayPal"	"I do not know if I accept payment through PayPal"	"DO_QUESTION"
"How can I contribute to Intel Developer Zone "	"I do not know how you can contribute to Intel Developer Zone"	"WQUES"
"What all does my policy include "	"I do not know what all your policy includes"	"WQUES_SIMPLE"
"Can I talk about the case "	"I do not know if you can talk about the case"	"BE_HAVE_MD_QUESTION"
"What 's the shortest goal you have"	"I do not know what the shortest goal I have 's"	"WQUES"
"Can written offers of employment for security/safety sensitive positions be made by email "	"I do not know how to can written offers of employment for security/safety sensitive positions be made by email"	"IMPERATIVE"
"This item was damaged as it was being shipped out to me , can I get some kind of refund "	"I do not know how to this item was damaged as it was being shipped out to"	"IMPERATIVE"
"Can I add a poetry reading after the opening prayer to the Johnson funeral service on Friday "	"I do not know if you can add a poetry reading after the opening prayer to the Johnson funeral service on Friday"	"BE_HAVE_MD_QUESTION"
"When should I use Amazon DynamoDB vs Amazon S3 "	"I do not know when you should use Amazon DynamoDB vs Amazon S3"	"WQUES"
"Can you help me change my password "	"I do not know if I can help you change your password"	"BE_HAVE_MD_QUESTION"
"How do I request medication for my child -LRB- the patient -RRB- "	"I do not know how do you request medication for your child -LRB- the patient -RRB-"	"WQUES_SIMPLE"
"How much will it cost to overnight this package to me "	"I do not know how much it will cost to overnight this package to you"	"WQUES"
"Do I need to have a formal referral to get an assessment"	"I do not know if you need to have a formal referral to get an assessment"	"DO_QUESTION"
"What is the Save for Later button and what is it used for "	"I do not know what it is used for"	"WQUES"
"What is the deadline to submit Reclassification Requests "	"I do not know what the deadline to submit Reclassification Requests is"	"WQUES"
"Do you sell gift cards to the Museum "	"I do not know if I sell gift cards to the Museum"	"DO_QUESTION"
"Can you get a price quote on new car insurance "	"I do not know if I can get a price quote on new car insurance"	"BE_HAVE_MD_QUESTION"
"I would like to create a registry on your website "	"I do not know how to create a registry on my website"	"IMPERATIVE"
"What is different about this CIBC Run for the Cure site "	"I do not know what is different about this CIBC Run for the Cure site"	"WSUBJ"
"How much do your storage systems cost "	"I do not know how much do my storage systems cost"	"WQUES_SIMPLE"
"Who is eligible to serve as a juror in DeKalb County "	"I do not know who eligible to serve as a juror in DeKalb County is"	"WQUES"
"Does it matter who I name as my second cardholder "	"I do not know if it matter who you name as your second cardholder"	"DO_QUESTION"
"What is the Civil Service Retirement and Disability Fund "	"I do not know what the Civil Service Retirement and Disability Fund is"	"WQUES"
"What type of atmosphere does your studio have "	"I do not know what type of atmosphere my studio has"	"WQUES_SIMPLE"
"What areas are available to rent for events at the Evansville Museum "	"I do not know what areas are available to rent for events at the Evansville Museum"	"WQUES_SIMPLE"
"How does the department determine my level of technique "	"I do not know how the department determines your level of technique"	"WQUES"
"Does an employer have the right to search an employee 's purse or bag "	"I do not know if an employer has the right to search an employee 's purse or bag"	"DO_QUESTION"
"What are some areas or questions that should be considered ' off limits ' when conducting a job interview "	"I do not know some areas or questions that should be considered ' off limits ' when conducting a job interview questions should be considered ' off limits ' when conducting a job interview"	"WQUES"
"Do you offer a payment plan for more expensive items "	"I do not know if I offer a payment plan for more expensive items"	"DO_QUESTION"
"How do I remove my drawer"	"I do not know how you remove your drawer"	"WQUES"
"What benefits are included with my WCs membership"	"I do not know what benefits are included with your WCs membership"	"WQUES_SIMPLE"
"What can my family do at the Muncie Children 's Museum "	"I do not know what your family can do at the Muncie Children 's Museum"	"WQUES"
"Is there a height or age requirement "	"I do not know if there is a height or age requirement"	"BE_HAVE_MD_QUESTION"
"Exactly where is the museum located"	"I do not know how to handle 'Exactly where is the museum located'"	"CANONICAL_IDK"
"Do you have any more related products "	"I do not know if I have any more related products"	"DO_QUESTION"
"Will COBRA be available to me when I terminate employment "	"I do not know if COBRA will be available to you when you terminate employment"	"BE_HAVE_MD_QUESTION"
"Can I have your postcode for my Sat Nav "	"I do not know if you can have my postcode for your Sat Nav"	"BE_HAVE_MD_QUESTION"
"Can I leave my bicycle when I visit "	"I do not know if you can leave your bicycle when you visit"	"BE_HAVE_MD_QUESTION"
"Can you help me find an outfit for a party tonight "	"I do not know if I can help you find an outfit for a party tonight"	"BE_HAVE_MD_QUESTION"
"My account is locked , I have n't logged in for a long period of time , could it be possible that you lost my information "	"I do not know if it could be possible that I lost your information"	"BE_HAVE_MD_QUESTION"
"National Parks and Federal Recreational Lands Pass or ' Interagency ' Pass Program "	"I do not know how to handle 'National Parks and Federal Recreational Lands Pass or ' Interagency ' Pass Program '"	"CANONICAL_IDK"
"What is FDAAA "	"I do not know what FDAAA is"	"WQUES"
"Which financial analysts follow Cognizant "	"I do not know which financial analysts follow Cognizant"	"WQUES_SIMPLE"
"What if I am not able to pay my bill "	"I do not know what if you are not able to pay your bill"	"WQUES_SIMPLE"
"I want some Canadian currency since I am traveling next month . How long it will take before I receive it"	"I do not know how long it will take before you receive it"	"WQUES"
"Will you administer medication to my pet at a Wag Hotel "	"I do not know if I will administer medication to your pet at a Wag Hotel"	"BE_HAVE_MD_QUESTION"
"Can I get an update on the status of my application "	"I do not know if you can get an update on the status of your application"	"BE_HAVE_MD_QUESTION"
"Does the admission ticket to the Vatican Museums grant access to the Sistine Chapel "	"I do not know if the admission ticket to the Vatican Museums grant access to the Sistine Chapel"	"DO_QUESTION"
"What are the key components of a retaliation policy "	"I do not know what the key components of a retaliation policy are"	"WQUES"
"Can I use any kind of cell phone with your service "	"I do not know if you can use any kind of cell phone with my service"	"BE_HAVE_MD_QUESTION"
"Do you have children 's menus "	"I do not know if I have children 's menus"	"DO_QUESTION"
"How are the prices in Panama "	"I do not know how the prices in Panama are"	"WQUES"
"I cancelled my order but I do not see it cancelled "	"I do not know how to handle 'I cancelled my order but I do not see it cancelled '"	"CANONICAL_IDK"
"What 's the best app for menus"	"I do not know what the best app for menus 's"	"WQUES"
"Which fringe benefits are nontaxable to an employee "	"I do not know which fringe benefits are nontaxable to an employee"	"WQUES_SIMPLE"
"Are dogs allowed at the Museum "	"I do not know if dogs are allowed at the Museum"	"BE_HAVE_MD_QUESTION"
"What is the Difference Between Cat Hair and Fur "	"I do not know what the Difference Between Cat Hair and Fur is"	"WQUES"
"I placed an order with you and my package was supposed to be delivered , but I have n't gotten it yet and I do n't remember my tracking number . Can you help me track the package "	"I do not know if I can help you track the package"	"BE_HAVE_MD_QUESTION"
"What fees are associated with Dance Class"	"I do not know what fees are associated with Dance Class"	"WQUES_SIMPLE"
"I noticed something is out of stock - to you have a date you expect to have it back "	"I do not know how to handle 'I noticed something is out of stock - to you have a date you expect to have it back '"	"CANONICAL_IDK"
"When will my shipment arrive "	"I do not know when your shipment will arrive"	"WQUES"
"What language do I need to apply in "	"I do not know what language you need to apply in"	"WQUES"
"Can I talk to your supervisor "	"I do not know if you can talk to my supervisor"	"BE_HAVE_MD_QUESTION"
"Where can I get more information"	"I do not know where you can get more information"	"WQUES"
"I checked out my cart but did not see the discount yet"	"I do not know how to handle 'I checked out my cart but did not see the discount yet'"	"CANONICAL_IDK"
"I hold a temporary long-stay visa ' with residence permit exemption ' . Am I allowed to travel in the Schengen Area "	"I do not know if you are allowed to travel in the Schengen Area"	"BE_HAVE_MD_QUESTION"
"Is there still time for current DACA recipients to file a request to renew their DACA "	"I do not know if there is still time for current DACA recipients to file a request to renew their DACA"	"BE_HAVE_MD_QUESTION"
"I want my subscription cancelled after my free month trial expires "	"I do not know how to handle 'I want my subscription cancelled after my free month trial expires '"	"CANONICAL_IDK"
"Where can I find allergen information "	"I do not know where you can find allergen information"	"WQUES"
"I need to report a fraud for my saving account"	"I do not know how to report a fraud for your saving account"	"IMPERATIVE"
"I 'm rehiring someone who worked at the University of Tennessee previously . Do they need to have a background check and attend orientation "	"I do not know someone who worked at the University of Tennessee previously you are rehiring ."	"WQUES"
"Can I purchase a Membership for my daycare "	"I do not know if you can purchase a Membership for your daycare"	"BE_HAVE_MD_QUESTION"
"I have some questions about my monthly billing . Can you help me with that "	"I do not know if I can help you with that"	"BE_HAVE_MD_QUESTION"
"How does my team set up additional services like LTL Freight or Air Freight "	"I do not know how your team sets up additional services like LTL Freight or Air Freight"	"WQUES"
"Is The ECOMUSEUM ZOO subsidized"	"I do not know if the ECOMUSEUM ZOO is subsidized"	"BE_HAVE_MD_QUESTION"
"Can I leave a review for your product "	"I do not know if you can leave a review for my product"	"BE_HAVE_MD_QUESTION"
"Is the Welsh Mountain Zoo open all year "	"I do not know if the Welsh Mountain Zoo is open all year"	"BE_HAVE_MD_QUESTION"
"How much does it cost to ship a package "	"I do not know how much it costs to ship a package"	"WQUES"
"What is your cancellation/deposit policy "	"I do not know what my cancellation/deposit policy is"	"WQUES"
"Where can I do my banking , now that my former branch has closed down "	"I do not know where you can do your banking , now that your former branch has closed down"	"WQUES"
"How does Beyond Unlimited work when I 'm in Mexico and/or Canada "	"I do not know how Beyond Unlimited work you are in Mexico and/or Canada does when"	"WQUES"
"How do I set up autorenewal billing "	"I do not know how you set up autorenewal billing"	"WQUES"
"What is my account balance "	"I do not know what your account balance is"	"WQUES"
"Why is my account not active "	"I do not know why is your account not active"	"WQUES_SIMPLE"
"Can My child caregiver bring my children to the Parks"	"I do not know if your child caregiver can bring your children to the Parks"	"BE_HAVE_MD_QUESTION"
"Does the Museum have parking "	"I do not know if the Museum has parking"	"DO_QUESTION"
"Is membership limited to firefighters "	"I do not know if membership is limited to firefighters"	"BE_HAVE_MD_QUESTION"
"Where is the nearest location where I can speak to a IRS agent regarding my business 's audit "	"I do not know where the nearest location you can speak to a IRS agent regarding your business 's audit is where"	"WQUES"
"Why should you book Bucket Fillers , Inc. for a presentation "	"I do not know why I should book Bucket Fillers , Inc. for a presentation"	"WQUES"
"if i cancel my appointment , will my deposit be refunded "	"I do not know if your deposit will be refunded"	"BE_HAVE_MD_QUESTION"
"Do you only have cars on display "	"I do not know if I only have cars on display"	"DO_QUESTION"
"How do I add an additional appointment located at a different campus "	"I do not know how you add an additional appointment located at a different campus"	"WQUES"
"Will there be an effort to measure this law 's effectiveness in improving patient safety and healthcare "	"I do not know if there will be an effort to measure this law 's effectiveness in improving patient safety and healthcare"	"BE_HAVE_MD_QUESTION"
"May I use images designated as CC0 in a lecture , or for other educational purposes "	"I do not know if you may use images designated as CC0 in a lecture , or for other educational purposes"	"BE_HAVE_MD_QUESTION"
"When I try to upload my resume , I receive an error message instructing me to contact my security administrator . What do I do "	"I do not know when you try to upload your resume"	"WQUES"
"How soon will my items be shipped "	"I do not know how soon your items will be shipped"	"WQUES"
"I need to know your returns address so I can send back an item I received in error "	"I do not know how to handle 'I need to know your returns address so I can send back an item I received in error '"	"CANONICAL_IDK"
"Can you tell me what the late fees will be if I have to make my payment 2 days late "	"I do not know if I can tell you what the late fees will be if you have to make your payment 2 days late"	"BE_HAVE_MD_QUESTION"
"How much time should we plan for a museum visit "	"I do not know how much time you should plan for a museum visit"	"WQUES"
"The automotive parts I ordered have n't arrived to my location but the tracking says they 've been delivered . Will I be refunded for my purchase or will new parts be sent to me "	"I do not know if you will be refunded for your purchase or will new parts be sent to you"	"BE_HAVE_MD_QUESTION"
"How does TurboTax know which questions to ask "	"I do not know how TurboTax knows which questions to ask"	"WQUES"
"What 's the latest I can return an item "	"I do not know what you the latest can return an item"	"WQUES"
